170502 Bug source lookup launching string variables bootpath launch dialog stay	java classpath label library tab launch applet main resolution location
78853 Bug Variable assignment type mismatch	
335363 Add Java Exception Breakpoint dialog truncated text checkboxes font size increased	viewer button text attribute listener type selection handler table filter
229380 Bug buttons incorrectly enabled classpath tab	tab classpath button parameters java label viewer library launch applet
13834 Bug breakpoints external source	classpath button source library annotations path javadoc root viewer content
495641 Bug pngs jdt jdt doc plugins	install source classpath rule path root entry map debug property
112670 Bug toggle selection treeitem variables view	action breakpoint selection add delete display variable input pane jar
43554 Bug Creating breakpoint method signature method entry breakpoint	type debug target unit event method signature pattern dest types
10282 Bug Rendering changed variables	viewer type attribute column logical button map content java install
13364 Bug visual indication breakpoint condition	condition handler java redo undo view history compiled viewer assist
255031 Bug Missing EEs prevent project build	source java classpath container type call debug project replace path
37942 Bug Launch config dialog determine full location JARs listed classpath	classpath tab java main label launch system check applet loaded
300614 Bug Hit count field small Settings detail pane	pane ters type java reference array dead lock init ializers
472657 Redundant type arguments highter warning ignore	start library variable method instruction complete status snippet list detect
9825 Bug Action icon inconsistencies	classpath model launch java snippet source eval icon bundle window
33893 Bug Preference existant JREs	profiles command location jre combo environments button label container library
268393 Bug Debugger letting change String	debug options container map events expecting exception install suspend entry
78449 Bug Closed project error message problems	action breakpoint evaluation java selection add launched snippet debug filters
29297 Bug Debug honor multiple output folders	reference source object java handshake wait string array buffer ers
187000 Bug Debugger looses selection focus lot thread stack debug	handler redo undo viewer history view action condition suspend assist
17025 Bug Adding JREs	button location table container label jre block library selection list
173187 Bug Breakpoint unclear refactoring	element java destination
54407 Bug pass properties files	java label classpath library tab rule install applet main location
77449 Bug user monitor info unavailable	install reference button time java entry object list request location
142476 Bug TVT TCT Text boxes ovelap borders	java label classpath arguments library tab applet main system location
324246 pass project classpath external programs defined builders	classpath source path label rule entry java entries annotations launch
64663 Bug variables Variables Change accept hex	java evaluation variable type init ters snippet context stack object
275614 Bug REGRESSION threads longer expanded Debug view visible	annotation thread listener debug table java viewer expandable rule composite
1695 Bug DCR support process thread specific breakpoints GIYJTQ	supports thread install evaluation att list step map library event
31907 Bug Java Variable Settings row	button viewer text listener model variable qualified pane java selection
92838 Bug api add missing tags API cycles	exported display entries monitors removed tree changed path testing variable
53929 Bug Classpath tree entries FULL path	classpath refresh change listener exported current viewer tree tab listeners
72371 Bug Streams left open exception	install java library location button connection list table root selection
16063 Bug Preference size	logical column type viewer java location structures jre block expecting
13015 Bug stepping conditional breakpoint	java breakpoint preference debug step error logical descriptor method field
349400 Add Java support Debug	java hot replace build list delta debug files scrapbook unit
7392 Bug JDIThreads responding startup	hot supports step thread suspend debug options evaluation list java
52964 Bug Persist size debug pop size	request step java monitor thread stack type location frames event
7404 Bug Add Filter step filtering broken	filter button original filters step stack table expected add auto
330987 Missing tags increment bundle version	verbose resource bundle file print connected selection virtual listener destination
32494 Bug Insp Display actions menu enabled scrapbook	snippet selection action launched evaluation open display java event source
248054 Bug breakpoint annotation Highlighted	button annotation thread library type listener debug viewer content java
94452 Bug Timeout exceptions	suspend open compilation field debug timeout prompt integer button alert
400636 codeassist work Display view	model pane inspect display action source viewer presentation rule handler
52474 Bug Blocked opening Java Perspective CVS check	annotation display listener source java thread expecting action debug spec
33534 Bug Ant Editor range indication supported	suspend eval ters debug combo tab dynamic compilation timeout listener
57598 Bug Remove Scrapbook toolbar button	button filter table java viewer working editor breakpoint selection listener
40707 Bug Breakpoint remains enabled disabling setting hit count	java suspend count enabled thread compiled event debug target breakpoint
8458 Bug Inspect action variables view	ters model eval window presentation init ializers dead lock set
94474 Bug Unable change source attachment JRE jar	library java path button source lib location annotations classpath label
16152 Bug NLS pass	java location archive library resolve filter root path lib install
29474 Bug Contributions Context menu contributions support visibility element	snippet selection action launched evaluation display open java source listener
124203 Bug View management respect debug context manager	action event close java loaded config stack context source display
15662 Bug Display	label java classpath launch tab selection system button applet resolution
15667 Bug Adding Jar src lookup path remote launch	java label classpath library launch location tab system applet main
21823 Bug java debug model adapters	adapter element provider java qualified breakpoint model text label type
9026 Bug Compilation error breakpoints showing breakpoints view	handler debug redo undo java evaluation view event loaded config
77125 Bug Preference suspending breakpoint	java breakpoint error preference step debug label descriptor method field
125771 Bug unable create method breakpoints external source	action breakpoint java classpath source label selection add delete method
414029 Adapt Platform Debug API	monitor contended walking manager window machine virtual thread java heap
369480 Bug Fixed bug launchingsupport jar compatible JRE recognized latest builds	library location java jar filter resolve lib external archive install
27989 Bug Provide verification launch configuration API	source configuration proj jar lookup listener check java project block
208744 breakpoints Unable watchpoints field declarations	type breakpoint java method start source target variable snippet pattern
120170 Bug breakpoints external source	classpath button source library annotations path javadoc root viewer content
34670 Bug Java Launch Configs DELETE key event lists classpath tab	classpath tab label java parameters map arguments launch install applet
144253 Bug source lookup Stack Frame CHANGE events longer force source lookup	java options suspend exception jar step lazy label selection source
53634 Bug JRE libraries don work running application	library java label classpath location tab button block environment applet
31110 Bug Debbugger Source Lookup work variables	java label classpath tab system applet main resolution parameters launch
463252 Bug Compile log warning JDT Debug	java snippet launched adapter evaluation debug breakpoint install type status
12695 Bug full breakpoints hit thread	java compiled suspend condition stack frame debug target projects project
73624 Bug Don prompt main main selected	java classpath label launch applet main button suspend tab system
43418 Bug busy cursor choosing JRE base directory	library java button location install label table selection list listener
9122 Bug debugging extremally slow latest	request ters init editor ializers dead edtiors field lock set
19363 Bug Missing wizard banner library container	source java container type classpath environment location library connector launch
50086 Bug Enhanced evaluation support	step evaluation thread stack java suspend supports filter location frames
421806 Debug support Java	jdi variable debug ping reference type array attributes uations reiving
9649 Bug rebuild returns	java location library start method variable snippet resolve filter lib
108473 Bug Performance performance eclipse severely degrades time	breakpoint warm performance count runs conditional hit measured min war
8634 Bug Exception breakpoints persisted	listener window test workbench
60364 Bug debug deprecated runtime code	att exception marker resolution ach core snippet instructions errors ner
109009 Bug Tests breakpoint export	selection listener bundle test description structured workbench
181204 Bug launching context launching resource based objects	source library java map container install property classpath entry jar
64984 Bug Inspect doesn work Display View	evaluation launched snippet java filters working inspect def install ininition
212442 Bug Failing importbreakpoints tests	listener working test values
70627 Bug JDI JDWP enhancements varargs	reference type file status thread argument stratum code method object
42984 Bug working directory args Ant processes	source java container arguments working classpath launch type block connector
22005 Bug Review runnables	step stack thread evaluation suspend frames async participant vote listener
394225 Bug Display evaluates incorrectly	install type status composite connector multi ivm
343039 Turn monitors	thread java monitor display owned map element debug hash base
110074 Bug Breakpoints breakpoint working	working values
167426 Bug InstructionPointerContext reference closed editor	java listener launched action display annotation evaluation snippet thread source
24579 Bug Deadlock checkout java project	java monitor thread waiting image base owning label ion dead
33292 Bug Source selected element Java Snippet Editor	snippet viewer attribute type button launched imports java evaluation content
184862 Bug evaluation evaluation method generics work	evaluation step thread stack java variable snippet method suspend loaded
1569 Bug inspect context inspect result GDKNZ	evaluation launched expression java snippet listener result text target stack
16930 Bug Eval incompatible thread	reference thread status object wait ers count list entry array
245793 Bug Eclipse Variables editing JRE preferences	entry jre container path classpath resolve library map install change
28195 Bug NPE shutdown debug remote launch	source java classpath label container launch connector tab environment arguments
26159 Bug NPE evaluating snippet anonymous	type evaluation snippet launched method start debug listener java source
10811 Bug Deregistered launches removed JavaHCRManager	debug call map annotation event detail thread evaluation change loaded
296505 Bug applet parameters trailing spaces	java parameters tab classpath launch label applet system resolution att
171075 Bug Java Editor Disconnecting Debug Session	java filter table editor display action content viewer button breakpoint
13909 Bug Inconsistent margins preference	block working type profiles java location label expecting jre preference
161364 Bug Evaluating Code Generics work debugging	model eval window presentation debug uating workbench target selection action
228985 Bug JREsPreferencePage java resizing problem	java location jre label evaluation debug block library container resolution
148615 Bug JUnit JUnit recognize JunitTestCase Test superclass	source project fragment java root modifiers folder test testing accessor
9861 Bug click work strings scrapbook	button working viewer list install thread scrapbook selection block table
22662 Bug IClasspathContainerPage context build path	event evaluation path snippet classpath launched rule loaded config entries
1674 Bug values method params NEE	parameters classpath java tab label applet system reference resolution event
71824 Bug choice stratum stepping	type file reference stratum code argument method java valid visible
145553 Bug variables modify String variable empty string Change dialog	viewer button attribute text type arguments attributes logical listener parameters
211625 option omit XstartOnFirstThread SWT projects MacOS	classpath java entry label container jre imports tab add connect
145592 Bug Debugger confused watchpoints fields	breakpoint java reference file method object count visible status debug
261837 Bug RuntimeProcess synchronize access fTerminated fExitValue	evaluation debug rule wait ening classpath java entries rules connection
19157 Bug JavaMethodBreakpoints hold debug targets	hot replace debug build list delta java files content thread
414939 Bug Error checking org eclipse debug examples mixedmode	java classpath label tab evaluation working container library connect launch
232699 Bug TVT TCT TVT Space missing colon sign French	current defined type file ast project java root sha erisk
11514 Bug Feature support JSP debugging	type java app location library att filter lib image resolve
4348 Bug ResourceMarkerAnnotaionModel unnecessary fireModelChange	listener working test values
18174 Bug Quotes execution arguments Java launch	tab launch label classpath java main system applet parameters resolution
24839 Bug TimeoutException debugging org eclipse tests	request ereated disconnect event handshake bytes stream output input server
320269 update JRE javadoc links Sun Oracle	library button java viewer lib location console install resolve filter
117516 Bug JDT java agnostic	listener test
46871 Bug Console buffer size limit	console java stack source lines string listener root property buffer
47390 Bug deprecated API SearchEngine	result type
23328 Bug Resume fails suspend breakpoint stepping BUG	step stack thread evaluation suspend frames ters lock async init
491299 Bug Classpath tab Java application wrong colors	classpath tab label java launch system main applet resolution parameters
260402 Bug Conflits JRE solved correctly	java label library classpath location tab block jre applet environment
54579 Bug Progress indicator flashes console output	console min string listener property buffer change lines war java
165174 Bug viewers selection lost launch view stepping sync block	button arguments annotation listener java thread viewer install table library
12598 Bug Launch config tab group API inconvenience	button arguments working text listener block tab argument combo dynamic
428862 Bug Unable install breakpoint	java suspend breakpoint install location ters debug library compilation scrapbook
88923 Bug evaluation Evaluations create compiled expression thread	java evaluation detail instruction map ters frame compiled debug stack
79706 Bug Detail formatter fails simple	java viewer debug formatter formatters handler preference breakpoint type step
94047 ActionSets classpath Toolbar shudders opening Classpath Variables preference	entry jre classpath change install adapter debug java map source
12640 Bug Workspace runnable correctly	java launched snippet debug evaluation compiled event label filters working
86887 Bug Conditions work JSP breakpoints	handler redo undo view history condition breakpoint viewer assist action
29036 Bug NPE debugging	reference type object array java instances root preference jdi field
53102 Bug Breakpoint installed accepted location verification	debug event java call installed target breakpoint filters instance enabled
10096 Bug Eclipse aware launched JVM JRockit	java location install library file resolve filter lib root destination
13684 Bug CoreException thrown project	java loaded config source path property install classpath map debug
12665 Bug ClassNotLoaded JDI exception conditional breakpoint	java breakpoint compiled warm target exception pattern image ion content
53115 Bug Contribute remote Ant support extraClasspathEntry	java source container type connector classpath launch open environment location
76675 Bug Pattern Matching independent IOConsole IOConsolePartitioner	java debug method source event lines fragment root target pattern
177542 Bug NLS translation questions	file reference java method location library jar visible info resolve
57257 Bug ArrayOutOfBoundsException debug event dispatch	event debug dialog expecting thread set lock spec tives map
6063 Bug Snippet Display JavaSourceViewerConfiguration	evaluation launched snippet result java filters working install rule ivm
16313 Bug NPE StandardSourcePathProvider	classpath reference type object set hash array java runtime entry
56252 Bug Console support enabled disabled lifecycles	java installed event debug instance target enabled listener image ion
42429 Bug escaping quotes	qualified model launch file label serialize working string buffer jdi
12740 Bug Wierd behavior debugging standalone SWT	filter arguments table editor breakpoint viewer thread add content type
339414 HeapWalking manager support debug targets provide IJavaDebugTarget adapter	breakpoint java debug listener build exception thread list instance hot
181220 Bug Variable text font update correctly columns turned	viewer button formatter arguments format table label qualified configuration model
72169 Bug debug context thread	java evaluation variable snippet expecting listener context stack debug type
