170502 Bug source lookup launching string variables bootpath launch dialog stay	java launch library source path classpath label main location button
78853 Bug Variable assignment type mismatch	assignment test top force tests shift string type incompatible object
335363 Add Java Exception Breakpoint dialog truncated text checkboxes font size increased	viewer button dialog create set text filter input type condition
229380 Bug buttons incorrectly enabled classpath tab	classpath button tab parameters dialog set launch java viewer create
13834 Bug breakpoints external source	source classpath library external set root test breakpoint button location
495641 Bug pngs jdt jdt doc plugins	install set source classpath java debug library path changed info
112670 Bug toggle selection treeitem variables view	action breakpoint display set pane selection project add event editor
43554 Bug Creating breakpoint method signature method entry breakpoint	type test breakpoint method entry java request create exit pattern
10282 Bug Rendering changed variables	test type changed set reference path variable viewer variables install
13364 Bug visual indication breakpoint condition	condition breakpoint suspend test set conditional history redo undo thread
255031 Bug Missing EEs prevent project build	java classpath source debug perspective project test types listener type
37942 Bug Launch config dialog determine full location JARs listed classpath	create launch breakpoint classpath java project main button debug tab
300614 Bug Hit count field small Settings detail pane	pane detail test set control context breakpoint sash create preferred
472657 Redundant type arguments highter warning ignore	type method declaration expression set instruction source array statement field
9825 Bug Action icon inconsistencies	test classpath create set launch text editor expression stack change
33893 Bug Preference existant JREs	library location java property set environments compliance button install profiles
268393 Bug Debugger letting change String	breakpoint changed java debug perspective test suspend install conditional change
78449 Bug Closed project error message problems	action evaluation java set breakpoint arg selection debug editor changed
29297 Bug Debug honor multiple output folders	arg test source input output handshake object console type read
187000 Bug Debugger looses selection focus lot thread stack debug	condition set context window history editor text selection redo undo
17025 Bug Adding JREs	column install selection location test library java list source changed
173187 Bug Breakpoint unclear refactoring	type method test unit breakpoint target conditions point element anonymous
54407 Bug pass properties files	java library system classpath test source install location label properties
77449 Bug user monitor info unavailable	install library java path changed monitor column thread location selection
142476 Bug TVT TCT Text boxes ovelap borders	java label library test location entry classpath working breakpoint filter
324246 pass project classpath external programs defined builders	classpath source java path required set container environment attachment external
64663 Bug variables Variables Change accept hex	print reply set command test type evaluation java reference variable
275614 Bug REGRESSION threads longer expanded Debug view visible	type create debug thread event preference annotation manager test model
1695 Bug DCR support process thread specific breakpoints GIYJTQ	set test thread supports breakpoint type filter event method java
31907 Bug Java Variable Settings row	column selection text button test conditional set create viewer input
92838 Bug api add missing tags API cycles	test path conditional project reference tests mode variable java event
53929 Bug Classpath tree entries FULL path	classpath project add variable test entries container set resolution source
72371 Bug Streams left open exception	test java library perspective install set column location system event
16063 Bug Preference size	java perspective library column logical preference viewer debug event type
13015 Bug stepping conditional breakpoint	breakpoint conditional condition debug java test preference step suspend method
349400 Add Java support Debug	launch test source debug mode type breakpoint java set create
7392 Bug JDIThreads responding startup	set breakpoint thread supports suspend breakpoints event list filter test
52964 Bug Persist size debug pop size	type set step thread method stack expression java declaration test
7404 Bug Add Filter step filtering broken	filter step button supports set filters test hot stack input
330987 Missing tags increment bundle version	version connected bundle create list resource dir parse file connectors
32494 Bug Insp Display actions menu enabled scrapbook	action changed java selection snippet evaluation event context debug menu
248054 Bug breakpoint annotation Highlighted	type breakpoint test annotation declaration method member expression java conditional
94452 Bug Timeout exceptions	test perspective breakpoint debug open exception handshake timeout suspend close
400636 codeassist work Display view	set display context action pane selection editor java change text
52474 Bug Blocked opening Java Perspective CVS check	test perspective launch java view debug open remove shortcut annotation
33534 Bug Ant Editor range indication supported	search breakpoint set java text editor type method debug display
57598 Bug Remove Scrapbook toolbar button	create button classpath filter event selection editor column java launch
40707 Bug Breakpoint remains enabled disabling setting hit count	breakpoint set thread method test request suspend type count event
8458 Bug Inspect action variables view	debug set editor context display text exception evaluation target preference
94474 Bug Unable change source attachment JRE jar	library classpath test source location set java path variable install
16152 Bug NLS pass	library test java install location system source parse archive expression
29474 Bug Contributions Context menu contributions support visibility element	changed action snippet java display evaluation selection context debug set
124203 Bug View management respect debug context manager	create breakpoint context set debug launch action java project view
15662 Bug Display	event selection java set test column label display classpath text
15667 Bug Adding Jar src lookup path remote launch	test java classpath library label location resolution system launch project
21823 Bug java debug model adapters	test type breakpoint label conditional location adapter workbench expression element
9026 Bug Compilation error breakpoints showing breakpoints view	breakpoint test type java set debug create condition launch view
77125 Bug Preference suspending breakpoint	breakpoint java create test debug step perspective error filter label
125771 Bug unable create method breakpoints external source	action breakpoint java classpath source launch external label selection method
414029 Adapt Platform Debug API	java editor library selection test set type reference ins ensitive
369480 Bug Fixed bug launchingsupport jar compatible JRE recognized latest builds	test source location library java path add container environment file
27989 Bug Provide verification launch configuration API	source test project mode java required initialize configuration jar working
208744 breakpoints Unable watchpoints field declarations	type breakpoint method field declaration expression java access create source
120170 Bug breakpoints external source	source classpath library external set root test breakpoint button location
34670 Bug Java Launch Configs DELETE key event lists classpath tab	classpath launch java tab library parameters set install path label
144253 Bug source lookup Stack Frame CHANGE events longer force source lookup	source type breakpoint test java list debug top error required
53634 Bug JRE libraries don work running application	library java classpath location test label source libraries tab selection
31110 Bug Debbugger Source Lookup work variables	source java type launch classpath test label main debug def
463252 Bug Compile log warning JDT Debug	java evaluation snippet set changed breakpoint debug type workbench editor
12695 Bug full breakpoints hit thread	test breakpoint condition suspend expression thread conditional breakpoints cached java
73624 Bug Don prompt main main selected	java applet set main launch label button classpath project text
43418 Bug busy cursor choosing JRE base directory	library column install location java selection directory detect changed system
9122 Bug debugging extremally slow latest	test monitor request source method java values step filter ters
19363 Bug Missing wizard banner library container	test source classpath java library location container type set environment
50086 Bug Enhanced evaluation support	set type thread step supports method java declaration expression suspend
421806 Debug support Java	test launch mode jdi debug breakpoint set create type specific
9649 Bug rebuild returns	source java library location test install type directory breakpoint method
108473 Bug Performance performance eclipse severely degrades time	breakpoint test launch performance perf console debug tests breakpoints conditional
8634 Bug Exception breakpoints persisted	test breakpoint type java method conditional eval suspend thread condition
60364 Bug debug deprecated runtime code	breakpoint set create exception source java att code hot debug
109009 Bug Tests breakpoint export	test breakpoint type eval conditional method bundle tests condition location
181204 Bug launching context launching resource based objects	set source classpath library path install type project changed launch
64984 Bug Inspect doesn work Display View	set evaluation changed debug java context snippet editor selection working
212442 Bug Failing importbreakpoints tests	test type eval conditional method location breakpoint tests condition compilation
70627 Bug JDI JDWP enhancements varargs	print reply command type set method output reference thread jdwp
42984 Bug working directory args Ant processes	arguments set source java working configuration container classpath program tab
22005 Bug Review runnables	step test thread stack suspend set breakpoint evaluation breakpoints current
394225 Bug Display evaluates incorrectly	test eval set install type condition expression system working element
343039 Turn monitors	thread java event monitor debug model update handle count evaluation
110074 Bug Breakpoints breakpoint working	test breakpoint working conditional eval breakpoints method condition thread entry
167426 Bug InstructionPointerContext reference closed editor	set java arg editor changed create perspective text evaluation debug
24579 Bug Deadlock checkout java project	java image breakpoint thread text type test append debug monitor
33292 Bug Source selected element Java Snippet Editor	type set selection changed java evaluation editor attribute text snippet
184862 Bug evaluation evaluation method generics work	set evaluation breakpoint step create thread type eval debug stack
1569 Bug inspect context inspect result GDKNZ	evaluation java debug changed snippet expression editor inspect context text
16930 Bug Eval incompatible thread	test thread eval object reference force err type impl frame
245793 Bug Eclipse Variables editing JRE preferences	install path library container runtime classpath changed debug java compliance
28195 Bug NPE shutdown debug remote launch	source java test classpath label exception container connector launch tab
26159 Bug NPE evaluating snippet anonymous	type evaluation eval expression java set declaration source method snippet
10811 Bug Deregistered launches removed JavaHCRManager	breakpoint create detail debug project changed launch listener java event
296505 Bug applet parameters trailing spaces	java parameters launch tab dialog applet classpath label selection working
171075 Bug Java Editor Disconnecting Debug Session	editor create filter breakpoint text set selection java action button
13909 Bug Inconsistent margins preference	perspective java debug library preference block type working close open
161364 Bug Evaluating Code Generics work debugging	eval test set editor text generics evaluation context selection object
228985 Bug JREsPreferencePage java resizing problem	java evaluation breakpoint debug expression type library compilation compliance current
148615 Bug JUnit JUnit recognize JunitTestCase Test superclass	test method setup print build suite element project stack type
9861 Bug click work strings scrapbook	event column selection handshake button launch create list thread debug
22662 Bug IClasspathContainerPage context build path	project java create breakpoint perspective launch set debug build classpath
1674 Bug values method params NEE	method java parameters type breakpoint set classpath tab object array
71824 Bug choice stratum stepping	type set source supports output java code stratum create reference
145553 Bug variables modify String variable empty string Change dialog	test button set dialog project type create attribute viewer attributes
211625 option omit XstartOnFirstThread SWT projects MacOS	classpath java container path add install library runtime changed debug
145592 Bug Debugger confused watchpoints fields	breakpoint method java output type object supports set file field
261837 Bug RuntimeProcess synchronize access fTerminated fExitValue	type expression declaration set java evaluation debug access classpath statement
19157 Bug JavaMethodBreakpoints hold debug targets	test type debug method location changed types replace hot source
414939 Bug Error checking org eclipse debug examples mixedmode	java install classpath set library type label evaluation tab changed
232699 Bug TVT TCT TVT Space missing colon sign French	test type parse conditional file library setup source java top
11514 Bug Feature support JSP debugging	type library location test java install version image pattern breakpoint
4348 Bug ResourceMarkerAnnotaionModel unnecessary fireModelChange	test type conditional location eval condition breakpoint method working compilation
18174 Bug Quotes execution arguments Java launch	arg test tab java launch source label arguments string classpath
24839 Bug TimeoutException debugging org eclipse tests	monitor handshake test request source timeout impl method list argument
320269 update JRE javadoc links Sun Oracle	library java match classpath location install environment compliance container button
117516 Bug JDT java agnostic	test type conditional eval breakpoint method tests condition working location
46871 Bug Console buffer size limit	test arg console source path library setup event string program
47390 Bug deprecated API SearchEngine	search type set input java matches runnable element test open
23328 Bug Resume fails suspend breakpoint stepping BUG	step test thread set suspend stack filter breakpoint object evaluation
491299 Bug Classpath tab Java application wrong colors	classpath launch tab java test path label create configuration project
260402 Bug Conflits JRE solved correctly	java library classpath location label system container test environment install
54579 Bug Progress indicator flashes console output	search console test arg input output java matches stack string
165174 Bug viewers selection lost launch view stepping sync block	perspective test selection column button java changed arguments view project
12598 Bug Launch config tab group API inconvenience	tab arguments java set text button update working applet project
428862 Bug Unable install breakpoint	launch java debug library install location path set directory suspend
88923 Bug evaluation Evaluations create compiled expression thread	detail evaluation breakpoint set java type condition debug expression suspend
79706 Bug Detail formatter fails simple	detail java type debug formatter viewer preference handler dialog create
94047 ActionSets classpath Toolbar shudders opening Classpath Variables preference	install java classpath container path runtime changed library debug variable
12640 Bug Workspace runnable correctly	create java evaluation thread set test breakpoint event changed add
86887 Bug Conditions work JSP breakpoints	condition test breakpoint history undo redo set type viewer handler
29036 Bug NPE debugging	test exception java type array instances method collection code local
53102 Bug Breakpoint installed accepted location verification	breakpoint test install type set location event suspend thread request
10096 Bug Eclipse aware launched JVM JRockit	library install java location parse debug path directory file program
13684 Bug CoreException thrown project	project set breakpoint java create launch type debug path source
12665 Bug ClassNotLoaded JDI exception conditional breakpoint	breakpoint condition java conditional suspend test set debug evaluation thread
53115 Bug Contribute remote Ant support extraClasspathEntry	java source library set location install container launch connector evaluation
76675 Bug Pattern Matching independent IOConsole IOConsolePartitioner	test search method pattern input request java type set link
177542 Bug NLS translation questions	library file output source java system install location impl test
57257 Bug ArrayOutOfBoundsException debug event dispatch	event test perspective debug java open set top close events
6063 Bug Snippet Display JavaSourceViewerConfiguration	eval text evaluation snippet set java changed display editor selection
16313 Bug NPE StandardSourcePathProvider	test exception classpath type array instances collection list capacity manifest
56252 Bug Console support enabled disabled lifecycles	breakpoint set test thread request event java access instance install
42429 Bug escaping quotes	test arg conditional label eval condition string working file breakpoint
12740 Bug Wierd behavior debugging standalone SWT	filter editor event test arguments set thread expression working java
339414 HeapWalking manager support debug targets provide IJavaDebugTarget adapter	breakpoint set target thread list java debug changed test create
181220 Bug Variable text font update correctly columns turned	viewer button create set label dialog arguments detail ruler formatter
72169 Bug debug context thread	evaluation test java perspective eval type debug set source expression
