170502 Bug source lookup launching string variables bootpath launch dialog stay	 source library launch location java install path button problem directory
78853 Bug Variable assignment type mismatch	 assignment test top force tests shift string type incompatible object
335363 Add Java Exception Breakpoint dialog truncated text checkboxes font size increased	 create dialog set input viewer text condition filter button column
229380 Bug buttons incorrectly enabled classpath tab	 classpath button set dialog create tab parameters configuration selection text
13834 Bug breakpoints external source	 source classpath set external library test breakpoint root location path
495641 Bug pngs jdt jdt doc plugins	 set source install classpath java library debug path changed location
112670 Bug toggle selection treeitem variables view	 set event display pane context thread control project debug view
43554 Bug Creating breakpoint method signature method entry breakpoint	 type test breakpoint method entry java request create declaration exit
10282 Bug Rendering changed variables	 test type set changed reference variable path java create logical
13364 Bug visual indication breakpoint condition	 condition breakpoint test suspend set conditional thread java type evaluation
255031 Bug Missing EEs prevent project build	 classpath perspective debug java project test set types changed listener
37942 Bug Launch config dialog determine full location JARs listed classpath	 create breakpoint launch classpath project debug configuration button test set
300614 Bug Hit count field small Settings detail pane	 pane detail test set control context breakpoint create jdi preferred
472657 Redundant type arguments highter warning ignore	 type method set declaration expression source instruction statement create array
9825 Bug Action icon inconsistencies	 test classpath create set text launch change stack expression editor
33893 Bug Preference existant JREs	 set property library java current install location compliance workspace combo
268393 Bug Debugger letting change String	 breakpoint java changed perspective debug test conditional view change list
78449 Bug Closed project error message problems	 set evaluation java arg debug changed editor expression exception eval
29297 Bug Debug honor multiple output folders	 arg test source input output object handshake type impl project
187000 Bug Debugger looses selection focus lot thread stack debug	 set context condition window editor selection property step text evaluation
17025 Bug Adding JREs	 column install test source selection location changed java symbolic change
173187 Bug Breakpoint unclear refactoring	 type method test unit breakpoint target conditions point anonymous monitor
54407 Bug pass properties files	 test library source java system location path properties add compatible
77449 Bug user monitor info unavailable	 library install path java monitor changed launch column thread location
142476 Bug TVT TCT Text boxes ovelap borders	 test library set location breakpoint java working entry install control
324246 pass project classpath external programs defined builders	 classpath source java set attachment required environment container path external
64663 Bug variables Variables Change accept hex	 print reply set command test type evaluation java reference variable
275614 Bug REGRESSION threads longer expanded Debug view visible	 create event type preference debug test thread model manager perspective
1695 Bug DCR support process thread specific breakpoints GIYJTQ	 set test thread breakpoint supports type event method filter java
31907 Bug Java Variable Settings row	 column create set test conditional input selection type context text
92838 Bug api add missing tags API cycles	 test path conditional project reference tests mode variable java event
53929 Bug Classpath tree entries FULL path	 classpath project add variable test entries set container resolution source
72371 Bug Streams left open exception	 test set perspective library java column system debug location install
16063 Bug Preference size	 java perspective logical debug library viewer control view create close
13015 Bug stepping conditional breakpoint	 conditional condition test breakpoint debug suspend mated generics button buttons
349400 Add Java support Debug	 launch test source debug type set mode java breakpoint create
7392 Bug JDIThreads responding startup	 set breakpoint thread supports breakpoints suspend event list test types
52964 Bug Persist size debug pop size	 type set step thread method stack create expression declaration test
7404 Bug Add Filter step filtering broken	 filter step set supports test filters hot java dialog input
330987 Missing tags increment bundle version	 create version list parse connectors bundle install request classpath print
32494 Bug Insp Display actions menu enabled scrapbook	 changed java set context evaluation create editor action menu debug
248054 Bug breakpoint annotation Highlighted	 type breakpoint test annotation method declaration member expression conditional java
94452 Bug Timeout exceptions	 test perspective debug handshake breakpoint exception view label entry java
400636 codeassist work Display view	 set context display text changed change control editor selection pane
52474 Bug Blocked opening Java Perspective CVS check	 test perspective launch view shortcut changed manager remove open java
33534 Bug Ant Editor range indication supported	 search set java breakpoint editor text method type debug input
57598 Bug Remove Scrapbook toolbar button	 create classpath event filter button column launch selection editor type
40707 Bug Breakpoint remains enabled disabling setting hit count	 breakpoint set test method request thread create java type entry
8458 Bug Inspect action variables view	 debug set editor context text display exception evaluation preference selected
94474 Bug Unable change source attachment JRE jar	 library classpath test set location source variable java selection definition
16152 Bug NLS pass	 library test location system source parse java install expression directory
29474 Bug Contributions Context menu contributions support visibility element	 changed java context set evaluation editor snippet action change display
124203 Bug View management respect debug context manager	 create breakpoint set context debug java project launch perspective view
15662 Bug Display	 event set test column text selection display target thread create
15667 Bug Adding Jar src lookup path remote launch	 test library location classpath resolution source variable classes type install
21823 Bug java debug model adapters	 test type conditional label breakpoint workbench thread method error variable
9026 Bug Compilation error breakpoints showing breakpoints view	 breakpoint test type java set create debug evaluation launch perspective
77125 Bug Preference suspending breakpoint	 breakpoint test create debug java perspective step filter view method
125771 Bug unable create method breakpoints external source	 classpath source launch set breakpoint external debug required attachment java
414029 Adapt Platform Debug API	 java editor library selection test set type reference ins manager
369480 Bug Fixed bug launchingsupport jar compatible JRE recognized latest builds	 test source library location path java add container environment classpath
27989 Bug Provide verification launch configuration API	 source test project mode java required initialize configuration working single
208744 breakpoints Unable watchpoints field declarations	 type breakpoint method field declaration expression access create set watchpoint
120170 Bug breakpoints external source	 source classpath set external library test breakpoint root location path
34670 Bug Java Launch Configs DELETE key event lists classpath tab	 classpath set path launch configuration create button library java tab
144253 Bug source lookup Stack Frame CHANGE events longer force source lookup	 source type breakpoint test java debug list top changed error
53634 Bug JRE libraries don work running application	 library test location set libraries classpath source definition changed parse
31110 Bug Debbugger Source Lookup work variables	 source type test java launch problem debug classpath path resolve
463252 Bug Compile log warning JDT Debug	 java evaluation set changed snippet create type debug context breakpoint
12695 Bug full breakpoints hit thread	 test breakpoint suspend condition expression thread conditional cached java breakpoints
73624 Bug Don prompt main main selected	 set project java applet launch text viewer create event combo
43418 Bug busy cursor choosing JRE base directory	 library column location install selection directory java set changed system
9122 Bug debugging extremally slow latest	 test monitor source method java request values step filter frame
19363 Bug Missing wizard banner library container	 test classpath library set location container property wizard source definition
50086 Bug Enhanced evaluation support	 set thread type step supports method declaration expression suspend library
421806 Debug support Java	 test launch mode breakpoint debug set create perspective specific java
9649 Bug rebuild returns	 source library java location test set breakpoint directory types snippet
108473 Bug Performance performance eclipse severely degrades time	 test breakpoint launch perf console debug tests performance breakpoints java
8634 Bug Exception breakpoints persisted	 test breakpoint type java method conditional eval suspend thread condition
60364 Bug debug deprecated runtime code	 breakpoint set create source java code hot debug method pattern
109009 Bug Tests breakpoint export	 test breakpoint type eval conditional method wizard tests condition location
181204 Bug launching context launching resource based objects	 set classpath source library path launch type changed project change
64984 Bug Inspect doesn work Display View	 set changed debug context evaluation java editor text working selection
212442 Bug Failing importbreakpoints tests	 test type eval conditional method location breakpoint tests condition compilation
70627 Bug JDI JDWP enhancements varargs	 print reply command set type method output jdwp reference thread
42984 Bug working directory args Ant processes	 set working arguments configuration tab program render check progress process
22005 Bug Review runnables	 step thread test set stack breakpoint suspend frame conditional object
394225 Bug Display evaluates incorrectly	 test eval set type condition install expression working system element
343039 Turn monitors	 thread java monitor event debug model handle evaluation count update
110074 Bug Breakpoints breakpoint working	 test breakpoint working conditional eval breakpoints method condition thread entry
167426 Bug InstructionPointerContext reference closed editor	 set arg create java changed perspective editor text evaluation debug
24579 Bug Deadlock checkout java project	 java image breakpoint thread text type test append set monitor
33292 Bug Source selected element Java Snippet Editor	 set changed java selection editor evaluation type text dialog debug
184862 Bug evaluation evaluation method generics work	 set breakpoint step evaluation create thread eval type debug stack
1569 Bug inspect context inspect result GDKNZ	 evaluation java changed debug editor context expression inspect set display
16930 Bug Eval incompatible thread	 test eval thread object force err type impl status reference
245793 Bug Eclipse Variables editing JRE preferences	 library path install runtime container classpath changed java debug resolve
28195 Bug NPE shutdown debug remote launch	 test exception connector configuration uncaught listen exclusive inclusive connection java
26159 Bug NPE evaluating snippet anonymous	 type eval evaluation expression set java declaration changed build method
10811 Bug Deregistered launches removed JavaHCRManager	 breakpoint create detail project java debug launch listener changed test
296505 Bug applet parameters trailing spaces	 parameters dialog selection java working applet create configuration button console
171075 Bug Java Editor Disconnecting Debug Session	 create editor filter set text breakpoint target changed selection context
13909 Bug Inconsistent margins preference	 perspective debug java library view message close open events test
161364 Bug Evaluating Code Generics work debugging	 eval test set editor text generics evaluation context object method
228985 Bug JREsPreferencePage java resizing problem	 java evaluation breakpoint debug expression compilation current compliance type runtime
148615 Bug JUnit JUnit recognize JunitTestCase Test superclass	 test method setup print build suite element project stack add
9861 Bug click work strings scrapbook	 event column create launch selection classpath handshake thread debug changed
22662 Bug IClasspathContainerPage context build path	 project java create breakpoint set perspective debug launch build changed
1674 Bug values method params NEE	 set method type breakpoint parameters object java test impl matches
71824 Bug choice stratum stepping	 type set source supports java output create code stratum hot
145553 Bug variables modify String variable empty string Change dialog	 test set dialog project create java reference attributes parameters select
211625 option omit XstartOnFirstThread SWT projects MacOS	 classpath path add container runtime install create changed library java
145592 Bug Debugger confused watchpoints fields	 breakpoint method type output supports set object field java hot
261837 Bug RuntimeProcess synchronize access fTerminated fExitValue	 type expression set declaration java evaluation debug access classpath statement
19157 Bug JavaMethodBreakpoints hold debug targets	 test type debug changed method location types replace source set
414939 Bug Error checking org eclipse debug examples mixedmode	 set java evaluation install update type plugin expression change library
232699 Bug TVT TCT TVT Space missing colon sign French	 test type parse conditional library setup top tests force method
11514 Bug Feature support JSP debugging	 type library test location version install pattern image java method
4348 Bug ResourceMarkerAnnotaionModel unnecessary fireModelChange	 test type conditional location eval condition breakpoint method compilation field
18174 Bug Quotes execution arguments Java launch	 arg test working source set configuration debug string file location
24839 Bug TimeoutException debugging org eclipse tests	 monitor test handshake source impl timeout listen method list stream
320269 update JRE javadoc links Sun Oracle	 library classpath match java location container environment current compliance install
117516 Bug JDT java agnostic	 test type conditional eval breakpoint method tests condition working location
46871 Bug Console buffer size limit	 test arg console library path setup event program render source
47390 Bug deprecated API SearchEngine	 search type set input java matches runnable element test open
23328 Bug Resume fails suspend breakpoint stepping BUG	 step test thread set filter breakpoint suspend stack object supports
491299 Bug Classpath tab Java application wrong colors	 launch classpath test path tab create configuration java set project
260402 Bug Conflits JRE solved correctly	 library test java location system install classpath container environment directory
54579 Bug Progress indicator flashes console output	 search console test arg input output matches java stack tests
165174 Bug viewers selection lost launch view stepping sync block	 perspective test column selection changed view java project launch set
12598 Bug Launch config tab group API inconvenience	 tab java set update project create config applet configuration handle
428862 Bug Unable install breakpoint	 launch debug library java location path directory install set problem
88923 Bug evaluation Evaluations create compiled expression thread	 detail evaluation breakpoint set java type debug condition expression suspend
79706 Bug Detail formatter fails simple	 detail java type viewer evaluation formatter debug create array test
94047 ActionSets classpath Toolbar shudders opening Classpath Variables preference	 classpath install java runtime container changed path library variable resolve
12640 Bug Workspace runnable correctly	 create evaluation set java thread changed test add breakpoint suspend
86887 Bug Conditions work JSP breakpoints	 test condition breakpoint set breakpoints method property viewer type undo
29036 Bug NPE debugging	 test exception java method collection code local type string instances
53102 Bug Breakpoint installed accepted location verification	 breakpoint test set install type location suspend event thread request
10096 Bug Eclipse aware launched JVM JRockit	 library location install parse debug path java program method change
13684 Bug CoreException thrown project	 project set breakpoint java type create launch debug test path
12665 Bug ClassNotLoaded JDI exception conditional breakpoint	 breakpoint condition conditional suspend test evaluation set debug thread java
53115 Bug Contribute remote Ant support extraClasspathEntry	 set library java location evaluation install tab tool configuration console
76675 Bug Pattern Matching independent IOConsole IOConsolePartitioner	 test search method pattern input request set type link java
177542 Bug NLS translation questions	 library source output system file java location test install impl
57257 Bug ArrayOutOfBoundsException debug event dispatch	 event test perspective debug java open events top view force
6063 Bug Snippet Display JavaSourceViewerConfiguration	 eval set text changed java evaluation display editor snippet debug
16313 Bug NPE StandardSourcePathProvider	 test exception classpath type collection list local capacity manifest string
56252 Bug Console support enabled disabled lifecycles	 breakpoint set test thread request access java install modification image
42429 Bug escaping quotes	 test arg conditional eval condition label type breakpoint debug string
12740 Bug Wierd behavior debugging standalone SWT	 filter test set editor event create thread java expression trigger
339414 HeapWalking manager support debug targets provide IJavaDebugTarget adapter	 breakpoint set thread debug changed java target test create mode
181220 Bug Variable text font update correctly columns turned	 create viewer set button detail dialog label ruler change preference
72169 Bug debug context thread	 evaluation test java eval perspective type set debug expression source
