59908 Bug DBCS recommned UTF XML encoding	encoding xml string jsp symbol dir attribute error info smap
48133 misspellings javadoc comment classes org apache core	cookie session mapper tracking context input max string type local
47111 Bug bug CVS component	realm digest change guarantee redirect container data string log roles
48139 Tomcat Javadoc unthrown exception fixes	mapper input expected type file stream function variable count local
50700 Bug Create patch omits parts source file	parse input filter servlet dispatcher request map ssl info event
51212 Bug Replace dialog prefilled original	file count output content manager form channel hronous item flags
50189 Bug AJDT install properly Eclipse	pos standard access log methods membership dir empty reference load
56334 Bug runtime prefs remove unused constants	context count servlet jsp sender session bindings visible pool impl
43538 Bug Ctrl Space key events	key selector file parachute channel poller thread data count ssl
44562 Bug Editors Editor dialog missing accelerators	count jvm tester flags replaced type output red irecting min
48149 misspellings org apache coyote org apache	parse port coyote session post dispatcher encoding set async output
48661 Bug filter type reduce xml selection	selector counter blocking key linked reference queue poller integer selectors
48150 misspellings javax servlet	schema web server resource context filter config dtd service data
48151 Java files don headers	size file max buffer upload stream header base item mime
46105 Bug Unable launch programs	queue socket linked dispatch atomic channel size gram deep string
18462 System err overriden output System	attrs redirect jsp output err file ant stream action directive
53792 Bug Scalability Prioritizing indexing searching working	path servlet file manager http channel input dir app root
53793 Change webapp links Manager point appname appname	context resource listeners filter application lock config map message redirect
48678 Bug JVE Palette persist open closed	count file buffer atomic handshake log selector open channel valid
37929 Bug Plan Item Improve scalability	item stream count progress field size current file preamble wait
49196 Bug Update correlation	realm jsp zone string icon stream digest member change cache
43053 Bug require reference cleanup expressions	context resource mapper local require cert method org change ssl
45101 Bug plan item Integrate RCP stream HEAD	stream file item size content progress boundary length field current
55343 Bug Unsupported protocol SSH OpenSSH	server count local realm rmi cert file digest org change
48176 Fields	method type visible input mime header file constant string invoke
45618 Bug Ant outline editor unable load DTD	lib separate start tester type result fail load array property
50228 Bug XOR mode doesn work	ssl mode realm log cert dispatcher file digest org change
42039 Bug JDT explorer doesn trigger decoration java files	protection output dir array string base xml manager attribute invalid
36923 Bug Font Print Margin Calculated Correctly	color face simple load rel event start format fail number
50747 Bug SSH CVS Plugin connect	tag count plugin session latch cur request data servlet leaked
49217 Bug tools jar Ant Entries	string ant file jar stream array output javac methods local
49730 Bug source lookup Call stack editor annotation ambiguous	connection pool source valid entity body write read parser sax
58946 Bug Standalone compiler text incorrect Unix	encoding symbol jsp buffer string dispatcher text tag file xml
48196 arrays	msg member coord udp string channel mutex interceptor principal view
46666 Bug file entry popup window project	table window dec lock buffer method string ant context max
33356 Bug Read files dialogs override methods code manipulation	file jar references external attribute loader map list writer manager
49234 JMX Descriptor Modifications	info base hash bean broadcaster dir type zip resources lock
50771 Bug Provide RDB EMF model	servlet unload lock count info table wrapper jsp bean broadcaster
49749 Bug eclipse won start Solaris eclipse	count standard wait access data log dir reference path engine
57943 Bug Search wrong match info	file role context servlet path format user loader array dispatcher
42072 Bug Exporting deployable plugin hounour compilation directive compiler preferences	attrs jsp tag directive attribute text info dispatcher icon dir
48217 Loggers	log user format system node local hook pings map based
49757 correcting generics warnings	scope cycles parse values param servlet request factory expression string
34399 Bug Wrong build file generated variables	unload servlet jsp dispatcher removal output tag file stream exception
37984 Bug Hotkey popup click menu	servlet data string reader channel demo coordination array tatus blocking
54370 NPE mapping method	socket method linked waiting string manager requests path map parameters
41059 Bug working filter Breakpoints view	path servlet root string reenable file http dir app executable
48230 Unused imports	tag jsp attribute info trans prefix scripting xml include count
43622 Bug Multiple aspects difficult manage	string count create hronous channel integer atomic manager servlet usage
60008 Bug Remove Hyades documentation doc plugins	base tag plugin dir lock count resources list hash config
51306 Bug Port log interaction viewer UML	realm digest change guarantee redirect path container string log roles
54382 Nullpointer Exception activating SSI loading html file specific comment	ssi config webapp encoding type reg external err map ftime
47216 Bug Unexpected warning launching Eclipse Eclipse	user time log dispatcher servlet library file compilation jsp tag
56953 Bug project shared	redirect selector linked ant stream blocking output err print javac
57977 Bug Update breakpoint location verifier manage AST elements	role path context format user dir servlet array root file
56446 Bug opens project wizard	redirect ant stream bindings thread output err print erate javac
47744 Bug launch runtime workbench	socket count linked channel hronous session latch waiting string requests
41089 Bug Background color problem	color table face replicated key txt text simple model string
56449 Bug reference match Javadoc Code	context resource factory mapper reference key write change counter local
37509 Bug Open Declaration opens declaration local variables	tag jsp attribute info action sequence scripting nesting dependent node
47237 Bug Mispelt error message	realm jsp string stream digest change count session guarantee redirect
43142 Bug Feature update Unable access http	property realm cache factory reference write string digest entity channel
42119 Bug Preferences Workbench Fonts alignment	buf performance cache timeout org size data cert ssl time
59015 Bug Editor General browse button	jsp tag array table handler map text list info key
48266 Patch generics catalina	info host ssl max servlet cycles locks mode format prop
48267 Patch generics javax packages	ssl cycles mode big log info decimal host max random
37515 Bug Navigator Overview keyboard accessibility	test data ata stratum output str file invalid header smap
60043 Bug Incoherent sequence method Entry Exit events reported JVMPI	table servlet channel zip replicated key txt text model ast
50316 Bug Workbench Empty window overlaying Editor	window dec buffer context count max res frame sed val
58508 Bug Source Selected Element showing source selected element	jsp string entity channel body parser sax gram msg handler
43150 Bug Duplicate Entry CVS Compare	count entry context wrappers cache max wild redirect access string
57490 Bug Perspectives Saving size perspectives	hronous channel string manager usage count integer directory file atomic
39572 Bug Add option generate lazy method	channel table string start file map jsp attribute key error
56982 Bug Typing trigger CVS edit commit	output string method channel hronous auto usage commit invoke integer
42648 Bug Managed platform Cygwin Executable	file server path managed servlet rmi reg http bean socket
55960 Bug Pressing Preferences starts external browser	loader buf tld performance cache cert library change timeout org
56472 Bug Font Colour Active foreground white povokes nasty close widgets	selector color face linked queue blocking simple integer selectors ints
38553 Bug open illegal operation occurs	role selector format user ssl time buffer bean handshake linked
46243 Bug Extra click required compare	info realm tag log icon digest change string guarantee redirect
21157 Bug undo redo update filechanged astrix Editor bar	filter tester create type
57509 Bug Ant auto indent enhancement	context map tag property bean security array handler methods format
48296 Generics fixes	servlet cycles input factory expression map hash request called life
39592 Bug Misleading syntax error diagnosis	attrs jsp include prefix directive tag attribute undeclared syntax property
39088 Bug Create contribution error parser	mapper parser body dispatcher error sax servlet context file entity
58545 Bug character launch configuration clipped console	protection socket manager linked factory dispose poller parsing context cache
58547 Bug CTOR order prioritized correctly	pos message write read servlet jsp context runtime msg string
52405 Update Servlet Rev	file jsp xslt context check list builder sep message removal
43191 Bug osgi bundles bundles installed	jar references resource loader bean external manager list permission code
47799 Bug Code Formatter EMPTY STATEMENT	cache formatter local size current connection color face write writer
46264 Bug Function bounds wrong clicking function binary	mapper library map compilation function erate string hine error mac
43706 Bug Palette desc items editor doesnt wrap linux	count size wait loader tester update integer poll type loaded
49340 Webapp unavailable deploy start	dir deploy base file lock bean hash valid resources report
55996 Bug Sharing Wizard Resize sync	max thread work queue size block spare separator channel hronous
41666 Bug eclipse hangs startup refresh workspace	list stack string log ssi start collected opp node fail
48837 Bug workspace Fails building plugin JARs multiple source folders	string lib builder tag
48843 Bug Configure Branches dialog multi select	count ordering set conditional atomic string config send channel ers
54475 Bug Log Navigator won auto reload resources closed reopened	unload count servlet base config jsp exception cert dir group
41166 Bug Runtime Arguments improperly passed	path file servlet visible configuration latch http context dir app
53454 Bug Plat terminate process attached monitoring started	start thread executor format processor lock write log scan system
43216 Bug Errors plugin xml compilation errors	attrs jsp attribute string file error xml webxml smap parse
47827 Tomcat API methods declare Exception	writer base string manager custom concurrent error script vars tag
49876 correcting generics compile warning org apache tomcat util bcel classfile files	file dispatcher servlet compilation jsp err error processor tag wrapper
47320 Bug Ant view icons target confused Java decorator	cache jsp map msg attribute string webxml array connection smap
45785 Bug Problem saving Java editor project directory place	redirect file ant stream output err print javac string tester
48345 Bug Add plugin reference javadoc	tag mapper plugin type counter key linked reference queue cur
56025 Bug Log config area blown PDE	file servlet path context user session random dispatcher proxy configuration
56027 Bug Trim status space allocation	ssl socket poller include count sendfile list certificate cipher syntax
47836 Bug Change method signature improve editable table refactoring	table prepared col header session attribute tag local sql remote
45279 Bug Tasks Stale marker problems view	bind handshake reenable selector val prefix ssl impl lock buffer
49376 Minor corrections info properties	base log ssl mode bind visible count input info writer
38113 Bug Remove Inexact Matches enabled inexact matches	header match file add local server template change remote proxies
54497 Bug generation problems JVM Terminating Hyades	cert org ssl cluster ityname renegotiate string session local number
49890 Bug Create Patch wizard remember path file system	count info log ssl reenable mode create filter session manager
46819 Bug enable disable builder bug cancel	key count string org counter data channel cert ssl hronous
47331 Bug Wrong text error dialog	stream request count string reader converter red irecting executor builder
48870 avoid parallel arrays base types	compression servlet resolve property bean stream mime buffer response output
48358 Bug plugins don display provider	session server random tag plugin proxy count legacy tore secure
58603 Bug test release file opened runtime workbench	latch ixsem pos executor service fair queue count close
29936 Bug Sync feature site editors Update spec	resource tld realm digest change channel guarantee redirect hronous scan
50929 patch Ensure rethrown exceptions retain original	buffer listener write ssl mode log info host max random
49905 Bug DCR Quick assist unneeded bracing	test data listeners listener output lifecycle stream invalid header lock
59123 Bug button enable disable referenced libraries	buf table key performance timeout org replicated cache ssl size
49909 jstl support	output acters str string uts writer special representation stream array
52474 load listeners declared blank spaces tld file	context listeners filter application map lock tld xml servlet config
47866 Bug Internal error synchronize perspective	jsp encoding realm output coyote type nested context encoder change
42747 Bug refactoring aspect crashed compiler deleted body	tag attrs text attribute info jsp icon directive variable count
56573 Bug existing message side entering message	data count file stream servlet compilation jsp dispatcher session cookie
48895 Bug java editing performance killed unnecessary Java AST creation threads	thread time manager count remaining stopped renewal pool servlet fair
58119 Bug DBCS DBCS pre edit text DBCS	cert pos org ssl ityname renegotiate rel strict init res
52488 Bug Checkout project exists	redirect array attribute file webxml xml string jsp remote smap
46866 Bug books missing	count string flags channel output security bundle group jvm manager
52500 Improve client certificate authentication	message header key session size time random proxy bytes cert
43285 Bug Variable view empty	msg reenable bean impl member coord string jsp prefix channel
39704 Bug declspec supported GCC	count cert stream org ssl ityname renegotiate servlet reader converter
45851 Bug Compare editors updated file	invocation realm stats comparator hash digest change zip entry guarantee
54045 Bug Compare window EAST WEST cursor sash	context dec file buffer hash max res message ids frame
10526 Bug Decorators Decorator mechanism optimizations	cache servlet connection dispatcher count file set compilation hash jsp
56606 Bug Workbench Resource toggle button bar follow rule square tab style	table rule replicated key txt text model request string channel
58660 Bug Wording Limits tab Launch Config incorrect	count socket linked log session waiting requests integer load array
48421 Bug open plugin converter	tag plugin count servlet converter written hash output stream dispatcher
39724 Bug Status bar space read german	ssl socket poller sendfile list certificate cipher time count tai
59189 Bug cleanup sites	resource context local max text string change message file time
53565 Bug Improve manual builds	zip data string jsp prefix impl children executor root builder
43840 Bug read connection extssh	stream count reader buffered write read connection request auto data
50496 Bug Main TOC frame work Mozilla Firebird	servlet unload table read key channel jsp exception string removal
58178 Bug Content Assist completion	count write filter handler request create leaked send string latch
48454 Bug bookmarks tasks lost Eclipse crashes	pool selector user thread bind handshake log address tasks max
49991 Tomcat JAAS problem CDI	user context configuration jaas delegate config login credential gss handler
54087 Bug Install Location wizard working	path servlet string file array http dir app root executable
54599 Bug SSH Export SSH Key Dialog standard margins	server rmi cert count string local file org ssl socket
48973 Bug comment formatter prefs comment tab delayed	cookie session tracking context max string local strings tag bundle
58701 Bug Tag add support branch tags qualified	tag output acters file info jsp compilation library string chunk
49998 Bug Annotations sorted preference dialog	count log entry cert visible org access size max cache
53584 Bug JDI thread evaluations running endlessly extremely	socket thread parachute channel linked data manager ship tasks task
59217 Bug Combo editable text area accept Japanese text IME	tag attribute info jsp action count sequence scripting stream mark
45906 Bug Tasks Ability global task filters	thread pool redirect selector time bind handshake address tasks udp
27988 Bug checkbox tree behavior refactoring consistent	ssl servlet mode library compilation instance log info resolver random
39769 Bug Working directory block radio buttons	tld path servlet file selector attribute dir encoding root webxml
47453 Bug Monitors Threads view greyed	reenable impl string data log servlet jsp prefix source fair
50018 Javadoc corrections	mapper expected type impl function variable local
46950 Bug Adding source folder project complex code manipulation general issue	redirect array attribute webxml xml string size jsp cert smap
47462 Bug Remote Debugging working	path servlet timeout result file http dir app write root
52586 requests forwarded request attribute javax servlet path info assigned incorrect	parse request attributes server path header string context remote dispatcher
48498 Bug Add Paste refactoring	create string count start integer fail load atomic invalid builder
45427 Bug Strange behavior quickfix add field	jar references loader lock servlet resource external manager wait remove
56179 Bug synchronize view helpful fast view	msg channel starts reenable impl member coord prefix reader coordination
47478 Bug Switching JRE Library container	protection jsp tag count manager cert reenable org info context
50550 Bug Preferences Pref Workbench Add button mnemonic	buf table key performance jsp replicated string timeout org cache
46967 Bug Debugger leaves green background	table process thread background lock change start log scan map
58232 Bug DBCS Context search System failed Search	role base empty dir cache format user loader factory array
50556 Bug Mmnemonics Team pref	test data separate result array invalid property header condition lines
46462 Bug RCP Preferences Workbench switches click startup	buf performance cache cert timeout org size ssl time band
49536 webapps deployed accessing URL returns content	base dir deploy list jsp output lock bean hash content
48004 Bug Ant classpath problems	jsp tag servlet file attribute jar java xml string dir
47499 Bug Quick Diff hovers don text editor font	color face tester format simple type clock number hand font
47502 Bug Running Ant separate console output	result separate array property binding attribute condition cookie
56724 Bug Copy method body clipboard selection editor	tag array handler selector reference linked map manager counter channel
56217 Tomcat Manager Application Status	context listeners filter application config lock map servlet redirect references
45977 Bug Contribute variables plugin contributed	tag plugin servlet dispatcher file cur nodes map hash compilation
52121 Bug generate delegate methods option copy javadoc code manipulation	jar references external mapper file context attribute loader map list
47515 Bug view offer properties JRE classpath container build path	loader container manifest string ant change session count array stream
47518 Bug tools Tools broken runtime	redirect info tag icon ant stream output err print javac
55198 Bug Sync View Regression click synchronize	jsp msg channel nested context string reenable impl member hronous
56736 Bug Debug debugging code Debug perspective menu items Java operations	bean attribute block work source loaded realm string broadcaster smap
13731 Bug ability refresh hierarchy view type hierarchy	scan msg channel starts bean string reenable impl format member
52135 Global error handled	file max request data oname context bean xslt count url
50600 Bug Add description code formatter preferences	cache buf size performance write local cert acters timeout org
51119 Bug Overview agree sequence diagram view	msg reenable impl member coord string jsp prefix channel mutex
57265 Bug Update site builder create output folders demand	worker path servlet redirect realm string file change http encoding
48050 Bug Quick diff preference Ant Editor	tester type
51124 Bug Searching sequence diagram scroll correct area	table token size work channel key length bean org progress
59317 Bug Build Build Working Menu displayed working	path servlet file http dir app root executable headers env
44986 Bug Support Breakpoint groups	managed property user group data descriptor string array executor tag
39875 Bug launching Managing invalid launch configs	socket servlet message linked factory chain waiting string manager requests
55749 Bug Improve performance time based correlator	buf invocation time cache timeout stats performance hash interceptor pool
49095 Bug Compare large sections file	icon library context compilation qualified error ata output file qname
56777 configuration resources loaded places straight filesystem	protection file resource references jar classes context loader configuration manager
59849 Bug remove references deprecated AST LEVEL	context resource lock listeners config filter application servlet jar log
59850 Bug PRES Implement style presentation	realm configuration digest linked change guarantee redirect container loader listener
49099 Bug Reduced Search menu search	role base empty dir format user loader array path connection
42444 Bug Error building feature find plug versions	bean context deploy wrappers reg hash report wild base redirect
49613 Bug JUnit JUnit Test	bean factory big expression test data context integer tester
43470 Bug Multiple breakpoints location attempt add breakpoints running jobs	path servlet root file http string manager dir app executable
44494 Bug Remove direct dependancies Xerces plugin	log dispatcher file tag servlet compilation jsp impl number member
49103 Missing annotations	web count doc initializer time cache input xml jars gability
49104 raw types	token file param content notification text bean decoders write output
49105 Javadoc corrections	mapper expected type impl function variable local
49106 Unused imports	tag jsp attribute info trans prefix scripting xml include count
50642 Bug Wrong completion kind declaring argument type	broadcaster factory socket write status latch completion notification cache read
51155 Missing deprecated comments	listener member mcast service ship impl jvm request string manager
58836 Bug Markers Problem view update problems background builds	msg reenable user impl delegate member coord gss prefix channel
49625 Bug Breakpoint hit reported remote debug session	session parse path count string user dispatcher random context servlet
49116 Bug Workbench debug views	file user random change linked session realm reference context dispatcher
40929 Bug Version diff check cancel opening compare editor	pool status lock socket linked msg reference queue count prop
46051 Bug search Search details matched	role empty dir base format user context file path connection
46564 Bug dirty file Save Resources dialog exit	channel org data cert ssl ityname renegotiate delta rel lock
48613 Bug stack frames updated symbols shared libraries loaded	max unload servlet selector jsp exception tag linked removal blocking
51688 Bug Search Tree shouldn context menu	role context empty dir format user tld base connection zip
53737 Bug scalability memory search	protection role context format user base dir cache connection bean
52719 Bug Team loss functions compared	connector map tag info string jsp version func builder curr
48627 Bug Debug Perspective Shortcuts Menu actions don work	realm dispatcher bean string file digest ant change output guarantee
48629 Bug plug descriptors missing provider	bean count reg hash session latch integer executor searched paths
55798 Enabling Manager App process description inadequate	dir file path servlet config deploy base bean hash valid
55799 Bug Intro don	cert array org ssl ityname renegotiate path rel strict info
48143 Javadoc fixes	mapper input expected type file stream function variable count local
50192 performance issue revision	buf cache performance timeout time band buffer connection pool reuse
46096 Bug JVM Hyades java processes	background cert count org ssl manager process cluster ityname renegotiate
51220 Bug formatter api ContentFormatter pass indents based partition	local formatter format cache current color face log factory write
56365 Simplify Mapper StandardJarScanner	mapper context cache concurrent map hash resolver impl function variable
51249 Bug Performance problems PackageFragment getPath	buf cache session random performance proxy timeout secure generator time
51251 Patch add version parameter ant task	redirect stream err print set ets error fail file files
50230 Recursive dependency tomcat catalina tomcat catalina	manifest bean container string manager list array server extensions resource
31804 Bug Subclasses TextEditor longer create custom SourceViewers	writer hronous channel string manager usage count integer atomic jsp
51264 Context Manager Store configuration proposal	session process server context naming socket bind legacy change user
48197 XByteBuffer privatize fields Javadoc	frag mapper channel buffer linked size deep invoke integer type
52293 Bug Cryptic Error Message Platform Loader	protection context user xml manager configuration attribute error realm encoding
49227 toLowerCase toUpperCase work Locales	parse session string server dispatcher map list manifest input coyote
42071 Bug DCR Support Java source mapping	string stream reader custom converter external system names paces invalid
50273 Bug XML string values escaped	output string attribute acters allowed ssi external syntax code data
52326 log level failed loading	log user thread send packet recovery mcast service loop time
52328 Massive garbage production observed response writer	servlet response compression uri reader content writer mime stream request
48233 Loggers	log user format system node local hook pings map based
53353 Malformed contentType attribute charset values	content encoding charset dir remaining string error local jsp compilation
43117 Bug Code Assist Support doxygen context	path servlet realm cert org change http ssl lock encoding
51310 Connector destroyInternal Execution	thread max socket queue body count port spare time support
41074 Bug RFP Transactions spanning multiple life cycle operations	cycles string builder map hash called life iodic servlet
54387 servlets url warning	context listeners filter application lock map config servlet redirect references
53366 Running SecurityManager jsp returns blank accessed	references jar path servlet http jsp loader file dir code
56438 Bug Save Restore Configuration warn recover	protection thread file idle context cert apr send configuration time
58489 Bug Workbench create contribute drop menu actions action bar	manager channel hronous usage integer record create action attribute linked
58497 Unable custom implementation AbstractHttp Processor methods	nio alive ssl ajp data file protocol output input handler
50310 Manager detailed status display servlets	context listeners filter application config lock map redirect servlet bean
49290 JarScanner scanAllDirectories Tomcat start	scan tld security resource taglib jars digest dir webapp string
12428 request getUserPrincipal Misinterpretation specification	path servlet http type string file parameter filter context request
51348 Bug JavaStratumLineBreakpoint conditions don apply	servlet dispatcher realm digest change user tag guarantee delegate file
50325 Bug PDE classpath container working importing binary projects SWT fragments	pos servlet file loader path attribute encoding array dir webxml
53398 Incorrect tag XML response calling manager status XML	schema web context file resource xslt tag plugin prop builder
45212 Bug WorkingSets Link working sets Projects Packages Types views	path loader servlet cert file org http ssl dir app
52384 Bug OutOfMemoryError opening hierarchy Object	bean string locks prop context lock format status executor digest
58535 Bug batch asyncs progress forwarding	progress boundary length remote impl endpoint read encoding input buf
46252 Bug disabled exception breakpoint	worker realm service listener member redirect size atomic log change
28852 Bug Verification error tracing constructor takes arguments	parser exp set lock write manager token parent loader simple
56501 problems urlencoding webapp	encoding webapp virtual buf min idir fered output input classpath
46261 Bug Inefficient setClasspathContainer	realm change guarantee redirect digest bytes message container code data
53430 JVM crash startup version	standard cluster sessions access string manager log session dir reference
51386 HandlingType correctly handled server startup leads incorrect classes passed initializers	context listeners filter application lock map config servlet redirect references
44223 Bug Group widget doesn pass focus pressing mnemonic	ship item failure channel hronous string ping usage integer weak
49345 work correctly JSF composite components	invocation pool query stats broadcaster type failed hash prepare jmx
51395 application loads SAXParserFactory loader memory leak	protection deploy pool message report manager thread ctx start servlet
58568 WebappClassLoaderBase exposes system instance member	channel message failure mbr coordinator integer list array blocking atomic
57544 Bug OpenSnippetWizardAction	filter test data invalid header create set lines bean
58582 Bug ICompilationUnit reconcile client AST API level	mapper realm reenable digest change guarantee redirect path container string
45272 Bug EditorMgmt save icon toolbar	info tag icon jsp context dynamic map library attrs compilation
50394 Bug models common facades behavioral support save method ITestSuite	session basic max string idle output body count set cert
43236 Bug NPE DeltaProcessor	socket linked channel gram waiting string manager requests reference atomic
45285 Bug Multi select AntView	linked selector count atomic channel send nio list queue timeout
53481 Bug refactoring move Preview moving change	trans stream lex realm cert size literal jjmatched digest change
51436 ServletRequestListener fails access request parameters Expect Header	read string tracking size set pass encoding encoder enum url
51447 Session type Backup Primary	send sessions session counter time context start listeners message manager
53498 Atomicity violation bugs misusing concurrent collections	size max match write concurrent template user trailer add upload
51453 Requests open URL include Authorization header reach servlet	message servlet output user response deny authentication type set content
47364 Bug iterator clone provide copy arrayList order	pos count manifest linked member lock container list queue wait
51467 usage method start start thread	start channel table thread change processor string message lock write
48399 Lock fields	lock connection max info status idle validation write interceptor prop
46357 Bug Method view miscounting calls compressed data option	buffer write msg max dec reenable context listener data impl
55576 Order ServletRequest parameters preserved	servlet lock wrapper instance string load thread config notification jsp
50459 Bug DCR Compiler warning opportunity System println	jsp file source test string attribute array xml error library
55582 Concurrent issue TagFileProcessor	file output result timeout write tag handler string min executor
49442 StringManager fields	context resource visible result change message local mime write header
48424 logic creating objectnames connector mbeans	managed bean reg ctx failed naming container string separate log
53545 jsp action resources IllegalStateException classic custom tag	tag jsp info attribute body scripting array nesting count buffer
46381 Bug proper shutdown hook cleaning platform termination	channel log naming string cert count org change ssl context
52547 incorrect byeswritten log completed async request http	user async upgrade filter upload alive compression request file delim
46403 Bug Historic isDeleted method lingering content providers	file create request leaked ice integer load dev latch event
50503 Engine level Clustering work correctly web application version	context listeners filter application map lock config xml servlet redirect
54602 CConverter character decode underflow leaves bytes buffer	work charset block pos separator remaining size encoding mod ulus
51532 Performance Issue retriving JAR files TLD file parsing	protection jsp tld tag servlet context jar file type dir
56653 Bug Refactoring Difficult rename methods files included	file jsp content dispatcher info tag context servlet compilation files
56657 Parallel deployment sessionid belongs latest version webapp latest version	session basic jsp bind login sessions sign list onon detail
43356 Bug setting keyword substitution mode doesn work CVS modul checked folder project	redirect jsp servlet jar output size realm cert local digest
49503 Connectors bind ports Catalina load start	bind server port thread channel socket string message naming rmi
57700 Exception LifecycleListener Context webapp unreachable spite subsequent successful startups	user basic log requests login onon request session sso red
51557 Newline http header field obscures	field servlet stream item header size host content progress current
43366 Bug Hierarchy view names types	param reenable impl string jsp prefix body root builder options
45419 Bug browser add api read html memory Photon Browser	file handler content output item snake threshold integer strings lock
41327 Bug fragments bundle implemented	pos content output string strings web xml bundle manager resource
50547 Bug MessageBox locks application	lock status write locks count format prop info read bean
49525 Unabled store data HttpSession root context	session prepared col jsp sql event nested bind context connection
53624 sendRedirect doesn work dispatch AsyncContext	async request manager path listener context min idir servlet response
42361 Bug problem dialog boxes data fails errors reported	count connection pool write read session string jdbc interceptor integer
49530 Context correctly stopped shutdown	thread string naming context remaining send change start channel sessions
50554 Bad getClass lead concurrency bugs	reenable content output strings digest iteration bundle uptible cache err
55681 JSR message handling pointer thrown DecodeException caught PojoMessageHandlerWholeBase onMessage	string cycles handler primitive type room input stream lock map
45441 Bug IncompatibleClassChangeError runtime compiling option	tag unload count servlet jsp thread attribute xml string webxml
48517 SuppressWarnings unchecked document reduce scope	cache empty context jsp scope output map locks nested lock
46471 Bug add swap reflect	idle swap restart save invalid header session locks backup max
49543 Bug Ole Invoke fill parameters	bean broadcaster method hash notification cipher suites order string type
56712 errors time calculations PersistenceManager	connection idle max validation exception test percentage info interceptor err
48523 Duplicate property files	context redirect servlet scan map file dir wrappers deploy security
45453 Bug pocketpc Pop menus work Tables	tag array handler stack parser create exp map info jsp
49550 PATCH Response isSpace deprecated isWhiteSpace	trans data info log host ssl max locks mode format
58768 Bug readme Variables View values references consistent	context resource file jar references list log loader buffer write
50582 Small JSPs Content Length chunked encoding AccessLogValve configured	size trans read user upgrade event max trailer progress upload
53654 JSP file recompiled file based TLD URL	jsp tld tag dir file servlet jar attribute error java
51615 Bug misc Annotation roll action Mark Occurrences removes sticky occurrences	tag worker jsp attribute info attrs action attributes sequence string
49570 CompressionFilter support HTTP proxies cache gzipped content sending Vary Accept Encoding header	trans file compression upgrade user read mime xslt size min
50601 Redundant checks equals	file compilation umask activity string loader listener source error required
56746 Webssocket secure client thread access webapp resources	context lock listeners filter application file resource loader jar map
43435 Bug CLASSPATH Project wrong NoSuchAlgorithmException	redirect array attribute webxml xml string jsp smap ant uri
50606 Bug workspace location fully qualified	configuration feature bean role loader classes names file context user
40380 Bug AspectJ honour libraries defined Project Properties	redirect ant tag info stream output err print javac string
49598 Bug place arbitrary controls table wrong tab order	field pos dir redirect work size stream length host block
50631 Bug Hook resource scheduling rule factory	config set ordering string entity loader channel body context hronous
37326 Bug breakpoints breakpoint actions context menu stack	unload count servlet jsp exception tag string removal replication listeners
38352 Bug OLE OleAutomation embedded objects	count file zip wait string integer poll type ata children
47569 Test cases clear	failure mbr webapp loader flags channel dir delete output tear
50646 Bug CTabFolder tooltips read	selector linked jsp stream blocking hash msg request string reader
53725 GZipped responses result java IOException Corrupt GZIP trailer gunzip	compression buffer size output read max user upgrade upload trailer
56797 API find overriden method	info bean cache concurrent factory write property lock methods weak
53735 Bug KeyBindings override editing java context general context	broadcaster notification string type load managed executor builder event bean
48616 Bug formatting Format messes link space	cert size org ssl format previous ityname renegotiate rel create
52724 incomplete resource leak bugs Catalina java	protection jar references pool manager classes thread loader resource external
50683 Servlet annotations scanned unpackWars	servlet web deploy xml initializer time doc cache bean count
55804 SPNEGOAUTHENTICATOR GSSCredential renewed RemainingLifeTime	parse user context role format thread time dispatcher input array
56848 Tomcat accept language parsing doesn properly handle IETF BCP language tags	protection socket item stream file context manager linked progress user
54802 Bug Delete IStatusLineWithProgressManager	file base dir dispatcher hash string resources servlet compilation config
59923 Bug Dialogs TitleAreaDialog setTitleImage NPE invoked early	protection socket manager linked factory dispose poller parsing context cache
48660 Bug DeferredTreeContentManager hard reuse	time size buf thread max timeout udp count performance cache
50709 org apache catalina core ApplicationContextFacade	user thread queue spare max log manager renewal pool tar
51736 Bug JUnit TreeItem test cases failing	message nio send select data log integer timeout load create
23066 Bug TextEditor performSaveAs doesn path file	filter fail load start create event init destroy bean
51741 Eclipse WTP Serve modules publishing broken patch tomcat	file xslt info ssl mode list accept builder sep entity
55842 response setBufferSize work properly	compression output filter buffer servlet active mime response stream factory
42530 Bug ServiceTracker open generates IllegalArgumentException	count string size file valid time open latch session messages
53800 Infinte loop FileDirContext CDI Weld project Eclipse Server modules publishing	redirect ant stream output err print encode javac string error
50737 Bug Overlap projects message won project root directory	file tld path servlet array string info attribute stream encoding
45628 Bug traverse ToolBar items	item notification stream count list progress broadcaster field size listener
56900 Bug Modal Window cascade	table window dec buffer color string face replicated context max
56902 Bug FastView views track fast view orientation	table queue add remove dispatch reenable replicated size text wait
57931 NIO connector incorrectly closes connection client certificate verification fails	ssl poller socket key apr count sendfile cipher list certificate
56907 Bug Font Colour WorkbenchPreview colors fonts presentation API	color user log face simple integer ints pings map based
35410 Bug VariableView fExpandedVariables cleaned	ssl mode message log info random initialized instance data string
42579 Bug Eclipse setting source folder parent output folder wipes source code	file session references jar loader prepared col xslt list sql
56917 Bug Listen MouseDoubleClick event TrayItem	bind atomic string address thread channel buf max udp selector
49750 WebappClassLoader validate validate javax servlet	jar references resource size connection pool loader info manager external
44633 Bug Outline View CModelBuilder quits templated friends	msg selector reenable linked impl member coord blocking timeout prefix
48729 Bug Support implicit properties	jsp tag realm file digest change resolve guarantee redirect container
43617 Bug Entire eclipse locked	lock remove time format locks system status prop wait cache
53863 Unable override servlet Tomcat embedded mode	jsp servlet file smap bean source jar tag attribute string
57969 PathParam annotation captures incorrect high load	lock encoding symbol wrapper read instance string notification number config
52858 High CPU load NIO connector client breaks connection unexpectedly	buf event connection stream cache performance count string timeout read
59014 Bug EditorMgmt gradient tabs slow Linux	invocation count pool query stats type hash jmx broadcaster notify
55943 Provide prevent System classloader webapp classloaders	loader jar references log user resource manager change list hash
41608 Bug failed move IFile left bogus	stream lex jjto remote literal jjmatched jjnew input reader channel
60041 Bug Feature Editor Install Handler URL MalformedUrlException	array tag info handler methods map manager names jsp compilation
51860 HTTP SSL NIO won work	nio socket buffer key parachute ssl handler write enabled linked
55956 Tomcat Manager Application Status	context listeners filter application config lock map servlet redirect references
48790 Bug Provide LogFactory logging proporties file Apache Commons	protection selector manager log linked blocking dispose poller parsing context
54939 logging maxHeaderCount hit	count max cache log size hash body handler cert bean
48795 Bug INavigable API	path basic servlet context file http login dir app root
51872 request getRemoteAddr returning address previous request	request header local nio port remote servlet proxies data values
59043 Bug content type AIOOBE ContentTypemanager findContentTypeFor	count write request start leaked filter fail load invalid header
38570 Bug Source generation wizards Add button open preference	jsp table count string key webxml attribute invalid map smap
54955 Mapping application context root returns reload	context listeners application filter config lock map servlet resources xml
59054 Bug Missing white space Search popup menu item	empty context data string channel space zip cookie token allowed
51887 Speedup sessionid generation running testsuite	session sessions random max attribute bind expires timestamp change user
53952 Bug type local variables displayed	info path cert count ials icon content org attributes tag
51905 Bug LogViewer omits entries depth	jsp servlet remove context content cert lock zip prop locks
49860 Bug Add EclipseErrorDialogOutputter GLA outputter xsd	schema web context resource dtd string validator local map resolver
42693 Bug overspecified directory path eclipse exporting feature	path resource file servlet http dir app directory root executable
53960 Extensions HttpClient test helper	manifest stream extensions resource container string reader converter dir delete
47826 Bug Wizards WizardNewFileCreationPage support file extension	size upload max trailer user compression buffer mime res sable
42707 Bug DCR Create field comment	mime header standard string threshold local context lock manager max
48861 Bug Problem whits object variables JavaBeans designer time	servlet unload jsp count exception dispatcher test change removal channel
41722 Bug refactoring Move Member type File breaks reference	trans type size failure ship member ping del integer weak
54012 pageContext tag files generated java code code generation JSTL tagplugin	
59138 Bug Profile config button config java attach	table count jsp session string map replicated key txt text
54022 CometEvent event suspended socket disconnect running Tomcat tcnative dll Windows Vista Windows Server newer	ssl poller socket count sendfile event parachute list cipher key
47881 Bug Compiler evaluates	test data
59145 Bug DND DND order GTK	pos order count channel queue cipher msg listener integer xml
59151 Bug Intro NPE Introduction	socket linked waiting requests concurrent queue server factory wrapper status
49937 Problems AsyncListener resource injection	context servlet resource filter listeners map application config lock redirect
56082 Bug junit test LaunchConfigurationDelegate preLaunchCheck	bean factory big expression test data integer invalid context header
58166 Bug ViewMgmt Console title foo improperly truncated	filter path fail load start create event info init destroy
47930 Bug RCP Move icons IDE workbench	server stream resource lex jjto remote literal jjmatched size jjnew
49985 Bug Eclipse crash leads unreadable workspace	stack test data string log ssi list opp node ical
58179 Atomicity violation	jar references loader servlet resource external path list string manager
40771 Bug ajde apis unnecessariy coupled swing	table replicated log factory key txt data text model string
46915 Bug Javadoc IPerspectiveListener	mapper expected type impl function variable local
49987 Bug EditorMgmt Typo IPageLayout EDITOR AREA org eclipse editorss	work block pos message separator size mod ulus tester integer
59206 Bug Perf JavaCommandStackPropertySheetEntry	filter test data format invalid header create simple lines bean
53067 WebSocket implementation issue wrapped requests	server result message user servlet output timeout endpoint write handler
54096 env entry rejects legal types	context map resource security env property ordering set filter log
59219 Bug Image data	token user log request leaked pings latch map based count
55125 Tomcat shut LifecycleListener exception	listeners parent server string manager loader hook file stopping config
43868 Bug Anonymous classes sort properly Hierarchy view type hierarchy render	scan dir string reenable bean standard access log jsp prefix
54115 Minor enhancements HttpClient test helper	deny log mode tracking ssl count stream base authentication info
56172 Bug EditorMgmt views editors close icon	info tag icon jsp context dynamic map library attrs compilation
47987 Bug Watson Error Debugging	jsp source string count unload servlet tag attribute exception loaded
43893 Bug Scrolling copies wrong bits	buffer servlet compression dec context max res frame sed response
55160 NIO connectionUploadTimeout work	max nio size user trailer upgrade send gable delim compression
47997 Bug empty opening brace formatter	formatter local lock current locks format color prop face status
56190 Bug CopyCommand objects reference	protection manager failed component poller thread key linked reference queue
59269 Bug ViewMgmt Search view flickers extremely updating	role format user buffer write connection impl zip string reenable
50054 AJP connector minSpareThreads	message max body size pool thread handler tomcat cert oname
49030 Bug wrong field hiding error reported	jar references item stream file loader classes allowed resource external
55177 connectionTimeout high CPU	selector linked item format system blocking integer bit selectors spare
46985 Bug ViewMgmt Javadoc Java docs IViewPart init confusing	buf mapper cache performance timeout type method time band buffer
41869 Bug Unexpected copying variables	configuration pos handler string reason role code loader classes file
52113 Tomcat reports missing context xml wrong location JMX deployment	context listeners application filter config lock map web resources xml
53138 download file size NIO connector tomcat version configuration download tomcat	session user nio process ssl buffer log file manager header
49045 JMX Enhancement Provision MBeanFactory createStandardService	naming string bean attribute hash notify await pool socket broadcaster
46998 Bug Generalize Type Cancel work refactoring	trans selector key queue hash linked count counter blocking reference
50105 Bug code formatter enhanced handle XDoclet tags	formatter local current color face write writer lock simple buffer
50107 StandardPipeline destroyed times	factory servlet catalina context sso
46011 Bug thisEnclosingJoinPointStaticPart resolved	mapper resolve string manager descriptor external system names feature scope
50108 Add missing setter getter AbstractXXXProtocol	info lock configuration write bean role methods loader classes flags
52156 ServletContext getResource path doesn accept	servlet loader jsp base jar file writer type change webapp
49086 Addition Javadoc Servlet annotations	web mapper xml doc initializer cache time count string types
44994 Bug provide automated management JavaDoc	mapper types param expected type function variable local object
49092 util IntrospectionUtils PATH SEPARATOR	jsp resource servlet jar type dir manager removal loader tag
40901 Bug ResizeTracker disabled cursor cursor intial	worker realm redirect size atomic log file digest change jsp
47046 Bug KeyBindings CapsLock	filter test data invalid header create set lines bean
50138 Bug editor context menu source surround	jsp tag array handler stream map info file method editor
49118 Inefficient String concatenation loop	text send packet recovery mcast service loop thread nio selector
49132 JNDI working	path stream servlet context file http dir app executable handler
48113 Bug Select element AntView single deletion	lock jsp wrapper param instance notification nio selector servlet undeclared
55282 JSF PhaseListeners duplicated	table string manager spec ials str uts map hash buckets
49141 Impossible naming factory SendMailFactory getObjectInstance	data initial context source ejb open connection
58357 Bug GridBag grid lines solid red dashed	jsp pos stream hash message ids snake msg game string
49142 Missing serialVersionUIDs	count string flags channel local output security bundle group jvm
49143 incorrect lazy initialisations	table string visible start sessions expire key txt replicated send
49144 Incorrect lazy initialization update fields	map table start key remote visible decoder processor string member
49151 Bug java lang OutOfMemoryError running LoggingUtilSample	parachute channel linked thread data socket ship context bean tasks
