59908 Bug DBCS recommned UTF XML encoding	 set test jsp error web xml path file encoding response
48133 misspellings javadoc comment classes org apache core	 cookie set session init mapper input external function tracking reader
47111 Bug bug CVS component	 set test context digest realm request security key property str
48139 Tomcat Javadoc unthrown exception fixes	 mapper function input expression external reader thread test object file
50700 Bug Create patch omits parts source file	 set path request session servlet attribute test add start async
51212 Bug Replace dialog prefilled original	 test file redirect cookies servlet client body uri post parameter
50189 Bug AJDT install properly Eclipse	 set method request test servlet add start smap body path
56334 Bug runtime prefs remove unused constants	 context read test servlet attribute sender set thread body function
43538 Bug Ctrl Space key events	 set socket key param entity request create start write read
44562 Bug Editors Editor dialog missing accelerators	 test property coerce method spec client path string cookies redirect
48149 misspellings org apache coyote org apache	 set request session path async parse internal remote header parameter
48661 Bug filter type reduce xml selection	 test filter key start request servlet set selector fail nio
48150 misspellings javax servlet	 servlet jsp url filter config http exception auto data body
48151 Java files don headers	 set file find add size remove servlet filter header application
46105 Bug Unable launch programs	 test socket set add path start webapp servlet context session
18462 System err overriden output System	 set jsp error print tag action redirect directive data xml
53792 Bug Scalability Prioritizing indexing searching working	 test set servlet bytes string path context socket output jar
53793 Change webapp links Manager point appname appname	 set add find context resource remove servlet filter application resources
48678 Bug JVE Palette persist open closed	 data test channel close message buffer handshake nio context open
37929 Bug Plan Item Improve scalability	 item size set content file stream parse headers header exception
49196 Bug Update correlation	 set update xml test dir war row add local message
43053 Bug require reference cleanup expressions	 test resource find object set expression internal type mapper method
45101 Bug plan item Integrate RCP stream HEAD	 test size stream response file body item request set content
55343 Bug Unsupported protocol SSH OpenSSH	 set server test async local realm socket count security rmi
48176 Fields	 header read enum fields type application method time methods annotations
45618 Bug Ant outline editor unable load DTD	 set property method test servlet string start spec fail server
50228 Bug XOR mode doesn work	 set test context digest realm internal security error credentials client
42039 Bug JDT explorer doesn trigger decoration java files	 set test file protection context xml web app deploy error
36923 Bug Font Print Margin Calculated Correctly	 servlet test start set access fail method request body info
50747 Bug SSH CVS Plugin connect	 test error response plugin tag context connection servlet body attribute
49217 Bug tools jar Ant Entries	 set test path stream log prop file add method type
49730 Bug source lookup Call stack editor annotation ambiguous	 set param entity test context pool add servlet property params
58946 Bug Standalone compiler text incorrect Unix	 test text jsp action servlet string start directive body request
48196 arrays	 test member principal set message buffer election interceptor view object
46666 Bug file entry popup window project	 set message string server window servlet count property renderer map
33356 Bug Read files dialogs override methods code manipulation	 set file web references find add xml context loader resource
49234 JMX Descriptor Modifications	 set jmx context add app deploy attribute notification pool bean
50771 Bug Provide RDB EMF model	 set servlet add security annotations bean jsp attribute notification time
49749 Bug eclipse won start Solaris eclipse	 set test path source encoding event root attribute session servlet
57943 Bug Search wrong match info	 set context servlet user file test string dir path role
42072 Bug Exporting deployable plugin hounour compilation directive compiler preferences	 parse jsp tag file directive attribute check body info action
48217 Loggers	 set log add base webapp find logger xml file standard
49757 correcting generics warnings	 set test type scope context find buffer request async event
34399 Bug Wrong build file generated variables	 test servlet context jsp set quoted tag file token path
37984 Bug Hotkey popup click menu	 test set context servlet print start word tag invalid lines
54370 NPE mapping method	 socket set function acc waiting open method endpoint close ssl
41059 Bug working filter Breakpoints view	 test servlet action string directive set jsp start path add
48230 Unused imports	 set tag jsp attribute action prefix body add directive type
43622 Bug Multiple aspects difficult manage	 request test annotations servlet multiple str string xml login response
60008 Bug Remove Hyades documentation doc plugins	 test context deploy app set tag plugin servlet start add
51306 Bug Port log interaction viewer UML	 test set path start request servlet digest security method realm
54382 Nullpointer Exception activating SSI loading html file specific comment	 config servlet ssi param file set time size add built
47216 Bug Unexpected warning launching Eclipse Eclipse	 set test context file create jsp info add init source
56953 Bug project shared	 set error redirect property selector shared server log timeout path
57977 Bug Update breakpoint location verifier manage AST elements	 set user context create servlet action string jsp role tag
56446 Bug opens project wizard	 set error redirect property thread stream server log path type
47744 Bug launch runtime workbench	 socket test context servlet tag async close privileged set channel
41089 Bug Background color problem	 set color info message action tag table renderer string parse
56449 Bug reference match Javadoc Code	 find key resource object internal type add remove expression context
37509 Bug Open Declaration opens declaration local variables	 set parse tag jsp attribute body action attributes scripting variable
47237 Bug Mispelt error message	 test set message error realm request internal security jsp context
43142 Bug Feature update Unable access http	 set property create param entity data error add digest body
42119 Bug Preferences Workbench Fonts alignment	 set test server socket buf servlet context performance header tag
59015 Bug Editor General browse button	 generate tag jsp method string property scripting action preamble set
48266 Patch generics catalina	 set message path lock context test status event ajp resolver
48267 Patch generics javax packages	 event test expression set context resolver size decimal mapper random
37515 Bug Navigator Overview keyboard accessibility	 test set context jsp servlet tag word invalid lines failed
60043 Bug Incoherent sequence method Entry Exit events reported JVMPI	 request renderer context jar url servlet event table doc filter
50316 Bug Workbench Empty window overlaying Editor	 set property annotations servlet string method coerce message context window
58508 Bug Source Selected Element showing source selected element	 set param error entity test body add create params data
43150 Bug Duplicate Entry CVS Compare	 context test set add map entry wrapper cache remove count
57490 Bug Perspectives Saving size perspectives	 test servlet param privileged async channel call group msg simple
39572 Bug Add option generate lazy method	 set test channel servlet web add start jsp xml fail
56982 Bug Typing trigger CVS edit commit	 node request test servlet connection privileged async channel output file
42648 Bug Managed platform Cygwin Executable	 set servlet server bean create context string user rmi path
55960 Bug Pressing Preferences starts external browser	 set create scan dir tld path resource info buf server
56472 Bug Font Colour Active foreground white povokes nasty close widgets	 set selector timeout info pro max nio pool request process
38553 Bug open illegal operation occurs	 set user message context role max ssl handshake buffer credentials
46243 Bug Extra click required compare	 set compare test tag digest realm info security property icon
21157 Bug undo redo update filechanged astrix Editor bar	 test servlet request multiple response filter add attr custom chunked
57509 Bug Ant auto indent enhancement	 add set generate tag jsp context map servlet scripting attribute
48296 Generics fixes	 set test context buffer async expression type event parameter request
39592 Bug Misleading syntax error diagnosis	 jsp set tag xml directive add action include attribute prefix
39088 Bug Create contribution error parser	 set test create context param servlet expression entity params error
58545 Bug character launch configuration clipped console	 set socket protection test enabled token quoted servlet acc hex
58547 Bug CTOR order prioritized correctly	 request test jsp set absolute message simple element quoted servlet
52405 Update Servlet Rev	 update row set check jsp session path servlet xslt context
43191 Bug osgi bundles bundles installed	 set references endpoint find resource thread server loader lifecycle add
47799 Bug Code Formatter EMPTY STATEMENT	 cache enabled test statement close pool info log interceptor connection
46264 Bug Function bounds wrong clicking function binary	 test set function tag create parser mapper jsp expression info
43706 Bug Palette desc items editor doesnt wrap linux	 test set property response method remote spec body expected type
49340 Webapp unavailable deploy start	 set add find remove test file context deploy servlet application
55996 Bug Sharing Wizard Resize sync	 set thread queue max size pool internal code message async
41666 Bug eclipse hangs startup refresh workspace	 set test start servlet method fail event filter lines tree
48837 Bug workspace Fails building plugin JARs multiple source folders	 request servlet plugin string test jsp bug xml builder writer
48843 Bug Configure Branches dialog multi select	 rule test set servlet method start post count configure cookies
54475 Bug Log Navigator won auto reload resources closed reopened	 set bean deploy max context time connection servlet app resources
41166 Bug Runtime Arguments improperly passed	 context set servlet string target method names path function parameter
53454 Bug Plat terminate process attached monitoring started	 set add start servlet find test security remove init container
43216 Bug Errors plugin xml compilation errors	 set jsp error xml tag attribute web action source validate
47827 Tomcat API methods declare Exception	 servlet dispatcher variable resource filter session set listener names exception
49876 correcting generics compile warning org apache tomcat util bcel classfile files	 constant context jsp java generated servlet compilation exception data error
47320 Bug Ant view icons target confused Java decorator	 set jsp web xml action cache member statement message directive
45785 Bug Problem saving Java editor project directory place	 set property redirect error method coerce string servlet spec context
48345 Bug Add plugin reference javadoc	 tag plugin object key context generate attribute function mapper variable
56025 Bug Log config area blown PDE	 set servlet context string test request path start config array
56027 Bug Trim status space allocation	 set socket ssl cache include count file jsp simple quoted
47836 Bug Change method signature improve editable table refactoring	 set tag info attribute header col session create notification file
45279 Bug Tasks Stale marker problems view	 set action jsp directive data buffer test servlet handshake count
49376 Minor corrections info properties	 set add find remove servlet version filter timeout resource read
38113 Bug Remove Inexact Matches enabled inexact matches	 set parse header file filter tag server digest jsp body
54497 Bug generation problems JVM Terminating Hyades	 session set bytes test cluster jvm trust append custom servlet
49890 Bug Create Patch wizard remember path file system	 test path annotations servlet session request root xml create list
46819 Bug enable disable builder bug cancel	 test key context servlet request channel rand set word expected
47331 Bug Wrong text error dialog	 test request client response message quoted connection body servlet cookies
48870 avoid parallel arrays base types	 set jjt parallel method compression servlet property string deploy response
48358 Bug plugins don display provider	 test session tag context set plugin servlet socket server generate
58603 Bug test release file opened runtime workbench	 test context servlet tag close file drops pojo buffer include
29936 Bug Sync feature site editors Update spec	 set scan digest realm resource security tld path credentials internal
50929 patch Ensure rethrown exceptions retain original	 write read content set unloading random writer buffer lifecycle invocation
49905 Bug DCR Quick assist unneeded bracing	 lifecycle test servlet context buffer set write word tag heses
59123 Bug button enable disable referenced libraries	 set test context servlet buf performance renderer event table string
49909 jstl support	 time display session set locale jsp url plugin response type
52474 load listeners declared blank spaces tld file	 set parse add servlet find filter remove context xml jsp
47866 Bug Internal error synchronize perspective	 set tag context nested variable servlet cookie digest property realm
42747 Bug refactoring aspect crashed compiler deleted body	 test tag body response servlet jsp directive action request text
56573 Bug existing message side entering message	 test servlet context message cookie count error java set generated
48895 Bug java editing performance killed unnecessary Java AST creation threads	 set thread test servlet annotations pool time connection max cleanup
58119 Bug DBCS DBCS pre edit text DBCS	 test node set start write smap servlet body action context
52488 Bug Checkout project exists	 set web error xml message redirect jsp property ajp file
46866 Bug books missing	 bean test security set data missing message error send decoder
52500 Improve client certificate authentication	 set session client user key header ssl time upgrade internal
43285 Bug Variable view empty	 test action message tag member jsp directive set invoke view
39704 Bug declspec supported GCC	 test servlet response annotations set message path connection custom request
45851 Bug Compare editors updated file	 set test compare member digest invocation realm query connection hash
54045 Bug Compare window EAST WEST cursor sash	 message file stream context source servlet str code skip max
10526 Bug Decorators Decorator mechanism optimizations	 set statement upgrade cache buffer response context pool dispatch close
56606 Bug Workbench Resource toggle button bar follow rule square tab style	 test request redirect web rule multiple post cookies body client
58660 Bug Wording Limits tab Launch Config incorrect	 test socket context request add servlet webapp start set fail
48421 Bug open plugin converter	 test context tag message servlet set plugin writer write attribute
39724 Bug Status bar space read german	 socket set ssl request file simple test sendfile quoted apr
59189 Bug cleanup sites	 set resource find message add directive internal remove cleanup text
53565 Bug Improve manual builds	 test action context tag jsp directive set attributes lookup servlet
43840 Bug read connection extssh	 test response connection context request message servlet chunked webapp client
50496 Bug Main TOC frame work Mozilla Firebird	 servlet close upgrade jsp input tag message frame data renderer
58178 Bug Content Assist completion	 test response send request set servlet buffer chunked endpoint write
48454 Bug bookmarks tasks lost Eclipse crashes	 set thread servlet buffer add base handshake buf task webapp
49991 Tomcat JAAS problem CDI	 set user upgrade names config token socket login context dispatch
54087 Bug Install Location wizard working	 servlet path test set string context socket request method prop
54599 Bug SSH Export SSH Key Dialog standard margins	 test servlet set server annotations request add start rmi socket
48973 Bug comment formatter prefs comment tab delayed	 cookie set session init tracking context plugin string quotes buffer
58701 Bug Tag add support branch tags qualified	 tag set info attribute type create coerce stream xml url
49998 Bug Annotations sorted preference dialog	 test set servlet annotations cache body access cookies log resource
53584 Bug JDI thread evaluations running endlessly extremely	 set socket channel thread jsp key write process data read
59217 Bug Combo editable text area accept Japanese text IME	 set test tag jsp response attribute body action request invalid
45906 Bug Tasks Ability global task filters	 set thread pool redirect buffer error filter servlet handshake server
27988 Bug checkbox tree behavior refactoring consistent	 set session request create path attribute info response lifecycle async
39769 Bug Working directory block radio buttons	 set test web path servlet xml file scan context error
47453 Bug Monitors Threads view greyed	 test action servlet annotations directive xml jsp add tag create
50018 Javadoc corrections	 mapper object function session expression external code type literal context
46950 Bug Adding source folder project complex code manipulation general issue	 set web error xml string test redirect simple output property
47462 Bug Remote Debugging working	 test servlet response context remote string server path body expected
52586 requests forwarded request attribute javax servlet path info assigned incorrect	 set request path header session async remote test http attribute
48498 Bug Add Paste refactoring	 test request servlet annotations start add method multiple fail xml
45427 Bug Strange behavior quickfix add field	 set add references find header remove resource loader thread async
56179 Bug synchronize view helpful fast view	 action message view test directive member jsp set tag interceptor
47478 Bug Switching JRE Library container	 set protection test tag context jsp server classes string count
50550 Bug Preferences Pref Workbench Add button mnemonic	 set server string session servlet sessions test invalid socket buf
46967 Bug Debugger leaves green background	 set process add internal container background member thread start channel
58232 Bug DBCS Context search System failed Search	 set dir user add context cache search role environment create
50556 Bug Mmnemonics Team pref	 set test bean context servlet property word tag invalid lines
46462 Bug RCP Preferences Workbench switches click startup	 set test start servlet server method socket buf fail performance
49536 webapps deployed accessing URL returns content	 set deploy context app test session servlet add client dir
48004 Bug Ant classpath problems	 set jsp servlet web xml test file path uri tag
47499 Bug Quick Diff hovers don text editor font	 property coerce test method string servlet spec info type relative
47502 Bug Running Ant separate console output	 set servlet jmx property attribute server bean cookies test result
56724 Bug Copy method body clipboard selection editor	 generate tag jsp method set scripting key preamble body handler
56217 Tomcat Manager Application Status	 set add servlet find remove context filter application resource path
45977 Bug Contribute variables plugin contributed	 context tag plugin generate attribute jsp generated java servlet source
52121 Bug generate delegate methods option copy javadoc code manipulation	 set add web references xml string find thread loader file
47515 Bug view offer properties JRE classpath container build path	 test set message client endpoint dir container server context loader
47518 Bug tools Tools broken runtime	 set error redirect tag path add info test param icon
55198 Bug Sync View Regression click synchronize	 action tag variable message jsp member test nested attribute context
56736 Bug Debug debugging code Debug perspective menu items Java operations	 set attribute enabled bean key data source managed digest notification
13731 Bug ability refresh hierarchy view type hierarchy	 set action directive member jsp event scan message view interceptor
52135 Global error handled	 set request check global server count servlet max internal xslt
50600 Bug Add description code formatter preferences	 set enabled time display server socket buf servlet performance string
51119 Bug Overview agree sequence diagram view	 action message view test member directive jsp body interceptor tag
57265 Bug Update site builder create output folders demand	 test set xml dir path war worker servlet context digest
48050 Bug Quick diff preference Ant Editor	 property test set coerce method string servlet spec type diff
51124 Bug Searching sequence diagram scroll correct area	 set bytes string boundary body buffer token stream size val
59317 Bug Build Build Working Menu displayed working	 test servlet path string context socket set url jar gid
44986 Bug Support Breakpoint groups	 test context set user group role remove parser trust custom
39875 Bug launching Managing invalid launch configs	 test socket request origin invalid simple type check endpoint set
55749 Bug Improve performance time based correlator	 set performance pool test async buf invocation max hash time
49095 Bug Compare large sections file	 set test create parser buffer servlet node info writer add
56777 configuration resources loaded places straight filesystem	 set protection thread references resource file find loader source lifecycle
59849 Bug remove references deprecated AST LEVEL	 set add find servlet remove resource context filter config listener
59850 Bug PRES Implement style presentation	 set connection digest idle test security data username names realm
49099 Bug Reduced Search menu search	 set user dir add context bytes search cache role environment
42444 Bug Error building feature find plug versions	 set context add find remove map start property bean wrapper
49613 Bug JUnit JUnit Test	 test invoke trust parser big custom expression bug literal attribute
43470 Bug Multiple breakpoints location attempt add breakpoints running jobs	 set test servlet action directive string request add start jsp
44494 Bug Remove direct dependancies Xerces plugin	 context log attribute jsp xerces test sender java iter generate
49103 Missing annotations	 annotations web servlet test read xml add annotation set config
49104 raw types	 type method set decoder message token param match file stream
49105 Javadoc corrections	 mapper object function session expression external code type literal context
49106 Unused imports	 set tag jsp attribute action prefix body add directive type
50642 Bug Wrong completion kind declaring argument type	 send set test notification method param quoted attribute wrapper bean
51155 Missing deprecated comments	 set port servlet mcast member async type stream listener message
58836 Bug Markers Problem view update problems background builds	 xml action dir war set member event directive jsp test
49625 Bug Breakpoint hit reported remote debug session	 set session path servlet context user request async string attribute
49116 Bug Workbench debug views	 set key action context jsp data write digest user smap
40929 Bug Version diff check cancel opening compare editor	 pool property test key member connection blocking channel string coerce
46051 Bug search Search details matched	 set user context bytes file dir cache role add search
46564 Bug dirty file Save Resources dialog exit	 set test session digest object login context access servlet delta
48613 Bug stack frames updated symbols shared libraries loaded	 servlet set jsp test tag max file source string timeout
51688 Bug Search Tree shouldn context menu	 set user create context cache role dir add environment path
53737 Bug scalability memory search	 set context user test protection add role login environment digest
52719 Bug Team loss functions compared	 test tag expression action function add string resolver external iable
48627 Bug Debug Perspective Shortcuts Menu actions don work	 set attribute session digest servlet jsp source internal realm object
48629 Bug plug descriptors missing provider	 test context managed error type bean body hash close register
55798 Enabling Manager App process description inadequate	 set deploy context file test add servlet app path remove
55799 Bug Intro don	 test set path servlet start fail root method session init
48143 Javadoc fixes	 mapper function input expression external reader thread test object file
50192 performance issue revision	 set performance test servlet buf filter build timeout cache buffer
46096 Bug JVM Hyades java processes	 session jvm test set error background cluster process servlet output
51220 Bug formatter api ContentFormatter pass indents based partition	 enabled log info attribute test format writer thread time set
56365 Simplify Mapper StandardJarScanner	 context set test param mapper function component method expression create
51249 Bug Performance problems PackageFragment getPath	 set test session performance buf random cache secure jar input
51251 Patch add version parameter ant task	 set redirect error jmx server add output create fail bean
50230 Recursive dependency tomcat catalina tomcat catalina	 create bean resource context list manifest hex file stream key
31804 Bug Subclasses TextEditor longer create custom SourceViewers	 servlet custom body test trust error privileged component writer async
51264 Context Manager Store configuration proposal	 set session server store key socket process token client service
48197 XByteBuffer privatize fields Javadoc	 set message buffer size object frag data mapper ack function
52293 Bug Cryptic Error Message Platform Loader	 set protection context web xml error user security jsp token
49227 toLowerCase toUpperCase work Locales	 set session path request async server add context socket attribute
42071 Bug DCR Support Java source mapping	 test servlet message web set request failed invalid socket lines
50273 Bug XML string values escaped	 time display parse set attribute add error str test url
52326 log level failed loading	 set log enabled add webapp recovery data lifecycle base context
52328 Massive garbage production observed response writer	 set test response servlet uri message compression buffer request output
48233 Loggers	 set log add base webapp find logger xml file standard
53353 Malformed contentType attribute charset values	 set jsp action tag directive session content test path file
43117 Bug Code Assist Support doxygen context	 set lifecycle servlet string test digest path realm internal parser
51310 Connector destroyInternal Execution	 set thread socket lifecycle max pool queue create internal body
41074 Bug RFP Transactions spanning multiple life cycle operations	 set test servlet connection max remove validation request event idle
54387 servlets url warning	 set servlet add find context remove filter path session xml
53366 Running SecurityManager jsp returns blank accessed	 set servlet path jsp references add find loader string thread
56438 Bug Save Restore Configuration warn recover	 set thread protection time context request pool max idle store
58489 Bug Workbench create contribute drop menu actions action bar	 test set request session multiple create response external object attr
58497 Unable custom implementation AbstractHttp Processor methods	 set ssl file size socket max thread request trust upgrade
50310 Manager detailed status display servlets	 set add servlet find remove write context filter resource path
49290 JarScanner scanAllDirectories Tomcat start	 set add find remove scan servlet resource tld path container
12428 request getUserPrincipal Misinterpretation specification	 servlet set path filter session string principal request async context
51348 Bug JavaStratumLineBreakpoint conditions don apply	 set servlet digest dispatcher test target realm token internal user
50325 Bug PDE classpath container working importing binary projects SWT fragments	 set test web servlet xml string add dir annotations context
53398 Incorrect tag XML response calling manager status XML	 set find add path servlet remove context resource attribute check
45212 Bug WorkingSets Link working sets Projects Packages Types views	 set servlet string test socket simple path buffer quoted parser
52384 Bug OutOfMemoryError opening hierarchy Object	 test path write set lock status context resource bean servlet
58535 Bug batch asyncs progress forwarding	 boundary stream data test servlet statement close send set endpoint
46252 Bug disabled exception breakpoint	 set test context worker mcast member message add realm digest
28852 Bug Verification error tracing constructor takes arguments	 set enabled expression info create query shutdown init suffix pro
56501 problems urlencoding webapp	 virtual servlet item file expected parameter filter test jar input
46261 Bug Inefficient setClasspathContainer	 set test context realm servlet security digest key property str
53430 JVM crash startup version	 set session test request servlet jvm change cluster add port
51386 HandlingType correctly handled server startup leads incorrect classes passed initializers	 set add servlet find remove filter context resource config resources
44223 Bug Group widget doesn pass focus pressing mnemonic	 test file servlet thread channel error context message common item
49345 work correctly JSF composite components	 set context pool jmx composite property lifecycle notification invocation hash
51395 application loads SAXParserFactory loader memory leak	 set load protection servlet test thread start find log context
58568 WebappClassLoaderBase exposes system instance member	 test member servlet loader log tcp thread channel message driver
57544 Bug OpenSnippetWizardAction	 test request context multiple servlet response word tag invalid failed
58582 Bug ICompilationUnit reconcile client AST API level	 set test enabled path redirect digest mapper security realm property
45272 Bug EditorMgmt save icon toolbar	 set tag info add test create filter qname init jsp
50394 Bug models common facades behavioral support save method ITestSuite	 set session test max object internal body idle save login
43236 Bug NPE DeltaProcessor	 socket context data channel waiting key set acc create test
45285 Bug Multi select AntView	 set data max selector sender channel nio event time fair
53481 Bug refactoring move Preview moving change	 set test client redirect realm digest security cookies server full
51436 ServletRequestListener fails access request parameters Expect Header	 test request size session response path invalid header servlet body
51447 Session type Backup Primary	 session set send sessions cluster object replication message time delta
53498 Atomicity violation bugs misusing concurrent collections	 set servlet session max size add path server resource selector
51453 Requests open URL include Authorization header reach servlet	 set session servlet user path response action request constraint token
47364 Bug iterator clone provide copy arrayList order	 member async absolute servlet rules fair test web manifest list
51467 usage method start start thread	 write set add print start internal container channel format request
48399 Lock fields	 set lock status max path member connection add info validation
46357 Bug Method view miscounting calls compressed data option	 rec send message write action set tag directive member jsp
55576 Order ServletRequest parameters preserved	 set servlet request security server path async privileged init add
50459 Bug DCR Compiler warning opportunity System println	 set servlet test jsp web xml init context file create
55582 Concurrent issue TagFileProcessor	 servlet context tag library server endpoint handler send drops client
49442 StringManager fields	 resource find read type header internal remove context enum add
48424 logic creating objectnames connector mbeans	 set bean context create remove add base event property type
53545 jsp action resources IllegalStateException classic custom tag	 tag parse set jsp generate body attribute scripting action attributes
46381 Bug proper shutdown hook cleaning platform termination	 set log server naming internal init channel find add privileged
52547 incorrect byeswritten log completed async request http	 set request filter socket path input servlet session alive max
46403 Bug Historic isDeleted method lingering content providers	 test servlet response request annotations start add chunked method fail
50503 Engine level Clustering work correctly web application version	 set add servlet find context remove xml filter application web
54602 CConverter character decode underflow leaves bytes buffer	 decode array encode buffer integer block size base servlet replace
51532 Performance Issue retriving JAR files TLD file parsing	 set find servlet add jsp protection remove tld create path
56653 Bug Refactoring Difficult rename methods files included	 context file servlet set stream filter attributes iable lookup jsp
56657 Parallel deployment sessionid belongs latest version webapp latest version	 test set session add servlet context webapp find sessions basic
43356 Bug setting keyword substitution mode doesn work CVS modul checked folder project	 set redirect property jsp path error output digest create servlet
49503 Connectors bind ports Catalina load start	 set server add remove thread message port base socket bind
57700 Exception LifecycleListener Context webapp unreachable spite subsequent successful startups	 test set session cookies servlet add login method init webapp
51557 Newline http header field obscures	 set header field content headers error servlet size stream item
43366 Bug Hierarchy view names types	 set action test directive jsp tag text method append connection
45419 Bug browser add api read html memory Photon Browser	 set headers digest login stream file cookies size server reject
41327 Bug fragments bundle implemented	 test servlet absolute web header set fragments body override relative
50547 Bug MessageBox locks application	 set lock request test response status path resource servlet connection
49525 Unabled store data HttpSession root context	 session set comet context connection servlet nested col path test
53624 sendRedirect doesn work dispatch AsyncContext	 context dispatcher servlet request path set dispatch filter listener fire
42361 Bug problem dialog boxes data fails errors reported	 set test connection request start servlet post max error method
49530 Context correctly stopped shutdown	 set thread pool server sessions internal queue rpc service context
50554 Bad getClass lead concurrency bugs	 set create param servlet save auto header filter ambiguous problem
55681 JSR message handling pointer thrown DecodeException caught PojoMessageHandlerWholeBase onMessage	 message handler test event context string life code cycle unsupported
45441 Bug IncompatibleClassChangeError runtime compiling option	 set jsp servlet web tag xml context file async queue
48517 SuppressWarnings unchecked document reduce scope	 context node set servlet scope path cache nested resource lock
46471 Bug add swap reflect	 test store idle session process set multiple servlet max generate
49543 Bug Ole Invoke fill parameters	 notification set attribute type invoke server bean hash request method
56712 errors time calculations PersistenceManager	 set tag connection session servlet validation test generate max idle
48523 Duplicate property files	 add set context map message scan error redirect servlet resource
45453 Bug pocketpc Pop menus work Tables	 generate tag node jsp push create scripting preamble method test
49550 PATCH Response isSpace deprecated isWhiteSpace	 set path parse ajp message lock status resource servlet cookie
58768 Bug readme Variables View values references consistent	 resource find set add action internal check references write directive
50582 Small JSPs Content Length chunked encoding AccessLogValve configured	 test set response request comet header jsp body array chunked
53654 JSP file recompiled file based TLD URL	 set jsp web servlet xml create tld init path file
51615 Bug misc Annotation roll action Mark Occurrences removes sticky occurrences	 set parse tag jsp attribute body worker attributes scripting text
49570 CompressionFilter support HTTP proxies cache gzipped content sending Vary Accept Encoding header	 set response request test check size header path xslt connection
50601 Redundant checks equals	 file read set session servlet source skip activity check compilation
56746 Webssocket secure client thread access webapp resources	 set add find servlet remove resource path context filter thread
43435 Bug CLASSPATH Project wrong NoSuchAlgorithmException	 set web error xml redirect test jsp property message output
50606 Bug workspace location fully qualified	 set find add servlet remove error security application filter wrapper
40380 Bug AspectJ honour libraries defined Project Properties	 set error redirect test string tag property source attribute fail
49598 Bug place arbitrary controls table wrong tab order	 set test field add absolute redirect error stream boundary attributes
50631 Bug Hook resource scheduling rule factory	 set rule test param create entity servlet params start add
37326 Bug breakpoints breakpoint actions context menu stack	 set test session servlet attribute jsp context interceptor tag replication
38352 Bug OLE OleAutomation embedded objects	 set context add async create fair remote content parameter upt
47569 Test cases clear	 test transformer loader member tcp parser directory add transformers decoder
50646 Bug CTabFolder tooltips read	 test response request error message jsp chunked string connection set
53725 GZipped responses result java IOException Corrupt GZIP trailer gunzip	 set size read buffer compression response header test headers upgrade
56797 API find overriden method	 set servlet add bean type create property session info names
53735 Bug KeyBindings override editing java context general context	 test servlet bean set start method notification add request filter
48616 Bug formatting Format messes link space	 set format request multiple response string rand chunked path body
52724 incomplete resource leak bugs Catalina java	 set protection thread references resource test add find loader log
50683 Servlet annotations scanned unpackWars	 set annotations servlet web add xml security config init context
55804 SPNEGOAUTHENTICATOR GSSCredential renewed RemainingLifeTime	 set user context path thread session attribute role add pool
56848 Tomcat accept language parsing doesn properly handle IETF BCP language tags	 set socket protection file size content token item header string
54802 Bug Delete IStatusLineWithProgressManager	 test xml dir war path app servlet delete context directory
59923 Bug Dialogs TitleAreaDialog setTitleImage NPE invoked early	 set socket protection context acc servlet factory security waiting dispose
48660 Bug DeferredTreeContentManager hard reuse	 set test action data response body time directive thread jsp
50709 org apache catalina core ApplicationContextFacade	 set load thread context init pool create base session queue
51736 Bug JUnit TreeItem test cases failing	 test start message log servlet request set multiple filter fail
23066 Bug TextEditor performSaveAs doesn path file	 test start request servlet set multiple filter path fail method
51741 Eclipse WTP Serve modules publishing broken patch tomcat	 xslt check path servlet entry render lifecycle map global context
55842 response setBufferSize work properly	 set response compression servlet send buffer header content add output
42530 Bug ServiceTracker open generates IllegalArgumentException	 test servlet start message set method request filter upload add
53800 Infinte loop FileDirContext CDI Weld project Eclipse Server modules publishing	 set error redirect test array string property integer result source
50737 Bug Overlap projects message won project root directory	 set path test web servlet error root xml file scan
45628 Bug traverse ToolBar items	 notification set size content item file find parse headers count
56900 Bug Modal Window cascade	 set context info message window start servlet renderer table response
56902 Bug FastView views track fast view orientation	 action set message directive jsp queue test add tag push
57931 NIO connector incorrectly closes connection client certificate verification fails	 set socket ssl size max header processor key cipher request
56907 Bug Font Colour WorkbenchPreview colors fonts presentation API	 set test context webapp servlet add color base xml standard
35410 Bug VariableView fExpandedVariables cleaned	 test servlet context cleanup log set lifecycle word invalid lines
42579 Bug Eclipse setting source folder parent output folder wipes source code	 set xml dir resource war test check references add find
56917 Bug Listen MouseDoubleClick event TrayItem	 set data thread servlet receiver time channel listen tcp request
49750 WebappClassLoader validate validate javax servlet	 test set response resource references validate find global expected loader
44633 Bug Outline View CModelBuilder quits templated friends	 action view message member directive test jsp set interceptor selector
48729 Bug Support implicit properties	 set tag test digest jsp realm parser resolve property security
43617 Bug Entire eclipse locked	 set lock remove path add servlet status time resource locked
53863 Unable override servlet Tomcat embedded mode	 set servlet jsp add resource attribute path create file test
57969 PathParam annotation captures incorrect high load	 set servlet scan load string security add error annotation init
52858 High CPU load NIO connector client breaks connection unexpectedly	 set connection test response comet close socket stream write request
59014 Bug EditorMgmt gradient tabs slow Linux	 notification pool set invocation slow hash test query statement max
55943 Provide prevent System classloader webapp classloaders	 set load add loader find references dir internal webapp thread
41608 Bug failed move IFile left bogus	 test set message request body stream ajp create string remote
60041 Bug Feature Editor Install Handler URL MalformedUrlException	 generate tag method jsp property set scripting custom preamble string
51860 HTTP SSL NIO won work	 socket set key nio write buffer ssl read output handshake
55956 Tomcat Manager Application Status	 set add servlet find remove context filter application resource path
48790 Bug Provide LogFactory logging proporties file Apache Commons	 set protection enabled pool shared selector timeout register log attribute
54939 logging maxHeaderCount hit	 set max enabled body cache count internal socket create upgrade
48795 Bug INavigable API	 test servlet context string set session basic login path add
51872 request getRemoteAddr returning address previous request	 set request header filter http remote test async max internal
59043 Bug content type AIOOBE ContentTypemanager findContentTypeFor	 test response servlet request start filter chunked method fail write
38570 Bug Source generation wizards Add button open preference	 set web test session xml servlet string invalid file error
54955 Mapping application context root returns reload	 set add servlet find context remove jsp filter xml file
59054 Bug Missing white space Search popup menu item	 set bytes cookie session quoted cache test context login literal
51887 Speedup sessionid generation running testsuite	 session set attribute sessions filter internal time max jvm create
53952 Bug type local variables displayed	 set test request response tag servlet path info chunked body
51905 Bug LogViewer omits entries depth	 set remove path add context lock servlet status attribute attributes
49860 Bug Add EclipseErrorDialogOutputter GLA outputter xsd	 test context system servlet xml invalid failed error lines namespace
42693 Bug overspecified directory path eclipse exporting feature	 test path servlet root context string set session error log
53960 Extensions HttpClient test helper	 test message socket extensions manifest endpoint upgrade header origin build
47826 Bug Wizards WizardNewFileCreationPage support file extension	 set test size max server socket upgrade header trailer parser
42707 Bug DCR Create field comment	 set header cookie enum session create item file type size
48861 Bug Problem whits object variables JavaBeans designer time	 servlet context jsp tag file set test internal property compilation
41722 Bug refactoring Move Member type File breaks reference	 set connection object message code test removal full ping response
54012 pageContext tag files generated java code code generation JSTL tagplugin	 source attribute jsp plugin loaded smap string locations test interval
59138 Bug Profile config button config java attach	 test servlet set add session annotations create start method sessions
54022 CometEvent event suspended socket disconnect running Tomcat tcnative dll Windows Vista Windows Server newer	 set socket comet ssl key thread count event file read
47881 Bug Compiler evaluates	 context test jsp tag resolver variable attribute compilation type space
59145 Bug DND DND order GTK	 request set test absolute message server response fair web order
59151 Bug Intro NPE Introduction	 socket acc waiting test set internal defer ssl local timeout
49937 Problems AsyncListener resource injection	 set add find context resource servlet remove rule filter listener
56082 Bug junit test LaunchConfigurationDelegate preLaunchCheck	 test attribute servlet invoke tag set parser big invalid lines
58166 Bug ViewMgmt Console title foo improperly truncated	 test path enabled servlet filter start request multiple root add
47930 Bug RCP Move icons IDE workbench	 set server message servlet stream ajp remote token size environment
49985 Bug Eclipse crash leads unreadable workspace	 set invalid test context servlet source string attribute lines smap
58179 Atomicity violation	 set references request find loader resource thread privileged lifecycle add
40771 Bug ajde apis unnecessariy coupled swing	 set enabled context renderer debug table log attribute shutdown replicated
46915 Bug Javadoc IPerspectiveListener	 mapper object function session expression external code type literal context
49987 Bug EditorMgmt Typo IPageLayout EDITOR AREA org eclipse editorss	 property string method coerce base integer spec array log buffer
59206 Bug Perf JavaCommandStackPropertySheetEntry	 test request context str multiple servlet response word tag invalid
53067 WebSocket implementation issue wrapped requests	 set servlet handler message server buffer send context endpoint result
54096 env entry rejects legal types	 add set rule context resource type map find servlet env
59219 Bug Image data	 set test response add jjt servlet ast token request context
55125 Tomcat shut LifecycleListener exception	 set listeners listener lifecycle context container add remove init data
43868 Bug Anonymous classes sort properly Hierarchy view type hierarchy render	 set action request directive jsp internal body scan attributes tag
54115 Minor enhancements HttpClient test helper	 test servlet version message set filter web deny lifecycle resource
56172 Bug EditorMgmt views editors close icon	 set tag info add test create filter qname init jsp
47987 Bug Watson Error Debugging	 servlet set test tag jsp request file source string attribute
43893 Bug Scrolling copies wrong bits	 set test message quoted compression response integer max token array
55160 NIO connectionUploadTimeout work	 set nio socket upgrade max size connection time alive input
47997 Bug empty opening brace formatter	 enabled path info lock find status servlet writer write test
56190 Bug CopyCommand objects reference	 set protection context key object reference mapper parameter nio blocking
59269 Bug ViewMgmt Search view flickers extremely updating	 set user action write role test context directive jsp credentials
50054 AJP connector minSpareThreads	 set test create max body response ajp internal read post
49030 Bug wrong field hiding error reported	 set test references find file size content quoted thread context
55177 connectionTimeout high CPU	 selector context set timeout file binary encode pro requested safe
46985 Bug ViewMgmt Javadoc Java docs IViewPart init confusing	 set context function mapper buf performance expression object met timeout
41869 Bug Unexpected copying variables	 set names bytes smap write action custom copy attr close
52113 Tomcat reports missing context xml wrong location JMX deployment	 set add xml remove dir servlet context find web war
53138 download file size NIO connector tomcat version configuration download tomcat	 set max request bean test header session size buffer ssl
49045 JMX Enhancement Provision MBeanFactory createStandardService	 set jmx server internal pool notification attribute property service add
46998 Bug Generalize Type Cancel work refactoring	 test key selector set max blocking servlet response count upt
50105 Bug code formatter enhanced handle XDoclet tags	 enabled info test log writer thread time access handler code
50107 StandardPipeline destroyed times	 context session cleanup internal valve attribute set event container pipeline
46011 Bug thisEnclosingJoinPointStaticPart resolved	 context property mapper set iterator feature resolver external resolve param
50108 Add missing setter getter AbstractXXXProtocol	 set add names method prop info bean parameter operation type
52156 ServletContext getResource path doesn accept	 set servlet jsp path context resource file dir create add
49086 Addition Javadoc Servlet annotations	 xml annotations web test dir servlet war add set config
44994 Bug provide automated management JavaDoc	 object expression function mapper bean test pool external met register
49092 util IntrospectionUtils PATH SEPARATOR	 set jsp create path add method servlet init prop resource
40901 Bug ResizeTracker disabled cursor cursor intial	 set test context worker file add digest realm security upload
47046 Bug KeyBindings CapsLock	 test request context multiple servlet response word tag invalid failed
50138 Bug editor context menu source surround	 jsp generate tag set test method scripting servlet string property
49118 Inefficient String concatenation loop	 set enabled directive recovery error text write member pool thread
49132 JNDI working	 test context servlet string socket user path stream webapp data
48113 Bug Select element AntView single deletion	 set servlet security max init add nio notification selector time
55282 JSF PhaseListeners duplicated	 set session send content attribute add http response locale request
49141 Impossible naming factory SendMailFactory getObjectInstance	 global data source context instance object handler wrap initial set
58357 Bug GridBag grid lines solid red dashed	 test jsp set message servlet tag smap body write action
49142 Missing serialVersionUIDs	 bean test security set data send message decoder jvm missing
49143 incorrect lazy initialisations	 set member message map request sessions response stream string port
49144 Incorrect lazy initialization update fields	 set member message map sessions entry port object start remote
49151 Bug java lang OutOfMemoryError running LoggingUtilSample	 set test socket channel key data write thread read comet
