334876 quick assist Invert conditions generates incorrect code	change type add proposal method remove processor correction modifier assist
28698 Bug Ctrl outline work file editor read	element editor action changed open type source selection file save
217126 Bug performance performance tests measure	editor test scroll java count invocation annotated text document tracker
272418 JUnit Support JUnit	reference unit test plan
425006 Bug quick assist Convert anonymous creation creates wildcard type	change action type proposal add method remove processor modifier correction
304174 hashcode equals Generated equals invalid Object scope	compare equals hash code relative plugin attribute element test generate
55349 Bug Delete key Quick Outline text box deletes text editor	selection mark outline color occurrences listener occurrence key action java
239695 jar exporter export JAR project folder project workspace	jar export manifest refactoring java files path packages location build
256087 Bug typing Automatically close brace work properly	format parameter delete text blank listener java root indent check
331864 JUnit Importing URL trim whitespace skip delimiters	version rsrc unit token word sentence single dependent handler character
462948 render method content assist adornment	proposal completion format parameter type java assist blank avoidance hint
341109 explorer Remove filters Explorer removes filters	action filter label folder project drop menu viewer container layout
151668 reorg Copy action add copy prefix	copy action move reorg rename open user message java paste
397447 hovering Code polishing Javadoc hovering feature	content type control enabled current info format blank parameter feedback
88195 Bug navigation Type search quick outline prefer enclosing type	selection action mark outline occurrences type occurrence listener java folding
53383 Bug incorrect progress message search view	action call dialog search hierarchy constructors field view key location
374920 preferences intuitive tab order editor preferences dialog	order registry java button dialog type sort file field hash
437398 ccp Don select extension file paste	action paste transfer type operation destination group search view generate
416915 tests tycho surefire plugin	refactoring test text include project indirection type resource bundle core
309415 Bug implementation nls tooling DBCS Find Broken Externalized Strings handle constants CJK Ext	action add selection handler generate substitution sort java prefix key
91306 Bug navigation Java file opens text selected	key file workspace tests external editor selection trigger button dialog
81078 Bug preferences Restore Defaults duplicates list entries	provider list formatter folding button field sort preference dialog java
385237 move member type Moving member file adds host type parameters	action type wizard input refactoring change method rename move rewrite
479440 rename rename options links hover	rename control strategy update info button field file warning elements
42208 Bug Source hover affordance text black	control hover scanner info preference editor key property text shift
66787 Bug Wrong capitalized filters message search	filter action call search type info dialog button invalid field
332008 quick Quick improved mixed projects	change type proposal add method remove correction processor quick modifier
46332 Bug Jobs longer responsive pressing ctrl	indenter viewer logging tree editor label form pane mode scrolling
318731 perfs Comments applied JDT performance tests obsolete	performance methods created binding unit compilation insert create base type
81172 Bug spell checking preferences Spell checking works report problems type enabled	problem checking spell sentence context spelling assist single linked preference
82204 Bug key binding Shortcut Open Declaration doesn context menu Java Editor	action text type java open editor listener input registry dialog
102696 quick Quick fail update method comment	change add method proposal type action remove processor quick modifier
9517 Bug Browser Perspective project doesn project view	text listener browser java selection perspective style action input sheet
153912 common navigator Java model hiding parent folders sync view	action content layout extension group view menu open label viewer
398648 Javadoc View inserts wrong asterisk link linebreak	action parameter open type radio control browser text listener javadoc
43332 Bug String Substitution Support org eclipse core variables	field button accessor check test source substitution nls refactoring project
232773 working sets Assign Working pre fill selected elements	working set action element dialog group button project elements scope
129354 Bug Keybinding focus javadoc editor	action text type listener viewer selection open jar key variable
466252 Bug templates template block	template dialog list code button type context viewer pixel generate
477523 Provide severity level	indirection descriptor status decoration context editor ter set viewer text
259413 refactoring Handler conflicts refactoring previews	refactoring history wizard status label delete descriptor resources change resource
312659 Remove unused NLS	clean unused change add remove code type unnecessary field members
53603 search search view expand collapse actions	action call dialog search hierarchy view set location field constructors
43364 Bug typing insertion wrong	typing text listener undo initial offset count test invocation spec
70005 content assist Missing Getter Setter code assist proposals	proposal change method add type remove processor modifier correction completion
186754 Bug explorer context menu empty selection	action call label view hierarchy selection folder location set filter
320916 Bug preferences Content Assist Advanced Read description entry fields	change proposal add type method remove processor modifier correction create
222609 Bug misc adopt schema identifier PDE	proposal computer java reference osals prop test unit sorting map
313751 typo modfier code	status type lang question mark context partition cached region refactoring
215448 working doesn Working List	working element set settings elements model table listener list project
199064 Bug dnd Element reordering DnD format field comments	action call hierarchy location copy selection elements view orientation search
90528 Bug Editor icon problem decoration instance	java listener registry image provider quick marker text type descriptor
279981 Constructor inlining produces illegal result	quick refactoring factory source tests project arate java root sep
480682 Bug override method offer override implement method	methods type method node created selected checked tree occurrence location
252340 clean Clean infrastructure minor documentation issues	clean add unused type remove code access change missing profile
70079 Bug rulers override indicators anonymous classes	test method text type nested anonymous java hierarchy instance lambda
59845 Bug performance Opening file editor compute overriding indicators	text editor open top thu auto pos override annotation thread
306646 Bug painting Print margin differentiate file type	tests temp rename decl check generate comp method top selection
320983 hovering Javadoc display properly classes type HTML element	javadoc text wizard current browser listener enabled selection input standard
49619 Bug formatting comment formatter leaves whitespace comments	tab array lines formatter profile dialog indent type preview space
233941 Bug ltk Refactoring history workspace refactorings year	refactoring history wizard status element delete label resources context resource
30169 Bug hover message bookmarks overview ruler	listener selection mark java occurrences action text occurrence type folding
255448 preferences Code Style preference single selection table	category type table filter dialog button viewer format content arguments
344552 Bug Source tabs cleared project closed	action java close reconciling factory correction bracket source remembered updater
59891 Bug formatter improve lines wrapping nested method calls	tab category type array style dialog arguments preview profile options
14837 Bug Java Search actions shouldn enabled folder selected packages view	action call hierarchy selection view location viewer element editor orientation
421383 Bug Graphics Scaling issues high DPI displays	dialog edit exit task todo check unit descriptor top members
144902 Bug navigation Explorer	project content container filters explorer set trigger adapter key selection
35339 Bug inheritedoc consistently rendered	names image color type format parameter blank root indent element
396808 hovering hovering multiple hyperlinks multiple location build path	list elements enabled dialog element current path existing curr location
52750 Bug correct indentation messes comment boxes	overlay participant lines check heuristic store listener clean box java
396809 hovering Write JUnits hovering feature	action enabled current references feedback operation write handler tag pool
252432 render API JDT Core provide display referenced jars	jar provide display working viewer browsing compilation switched style reads
329252 preferences content assist Auto activation delay mention unit time	completion proposal radio context activation temp field image iteration insert
329248 ltk file folder exist empty input resource rename dialog	refactoring file test undo change resource resources rename descriptor delete
13877 Bug NLS tool values displayed correctly	action view filter trace compute local hide input table selection
67124 Bug ccp dnd Minor Copy Paste issues	action copy move rename paste user group reorg message exists
165434 Bug Structure Viewers Reconcile structure document	collapse java document selection element header ion listener space manager
178744 Bug misc Editor opened sync resource refresh action	action call hierarchy view label location editor current mode toggle
79419 Bug Preferences link component	error dialog manager type element java list button job message
52801 Bug Press focus work spell checking hovers	text hover spell sentence context assist single checking linked list
108115 Bug refactoring Extract Local Variable Constant don find matching invocations methods	refactoring type change action method wizard rename input field processor
133731 Bug Field Assist Platform define preferences content assist colors	registry java text preference file assist radio completion field provider
13921 Bug Desire project property settings Ant integration	configuration javadoc jar script path wizard file doc project node
19043 Bug Config dialog Generate Doc Wizard bad	action button dialog javadoc error template open method type wizard
274023 Bug build path nested source folder build path rendered lib icon	dialog folder path project output add container wizard build type
38499 Bug Source Hover oszillates	hover annotation text type lines java key configure quick tif
64108 Bug Javadoc keywords settings longer work Java Editor	javadoc type wizard source text root browser style parameter listener
62062 Bug Mark Occurrences annotation text interesting Tooltip Description	action selection occurrences element java open dialog type filter find
47731 Bug JUnit view leaks Colors	test unit action filter dialog config launch project time type
28277 Bug clicking Types view refreshes decorators	action call type view label hierarchy dialog viewer search refresh
211578 Bug build path Dialog extend classpath variable slow	dialog folder project path output add container type wizard group
312966 Bug hovering text Javadoc hover view visible Ubuntu	listener hover text annotation type browser lines source info control
421506 Bug Suggestion align Additional Save actions desired code Eclipse contribution guidelines	file preference format button registry context java text action actions
37513 Bug misc Outline tool window remember size position	selection action mark occurrences outline type java occurrence editor listener
492173 Bug Missing styling Java project wizard	add change dialog type remove folder clean path project method
304792 move method Move single function interfaces work	refactoring type method change move rename processor constructor analyzer copy
32412 Bug ccp progress monitor rename prompt copy pasting file	quick image annotation listener change info history action descriptor rename
126625 Bug missing options formatting annotation types	tab array sep profile dialog space type problem java source
330415 inline Refactor Inline fails parenthesize replaced arguments	action extract handler convert temp type introduce nested selection dows
12996 Bug open multipage editor Invalid thread access exporting jar	dialog jar folder file type project path wizard manifest text
19145 Bug Wizards wizards resizable bounds	dialog configuration pattern list element source curr block rule annotations
312014 content tree view projects folders export jar read screen readers	jar manifest export file description refactoring checkbox status destination packages
244431 preferences Outgoing change preferences change	java label preference block search listener change scanner color button
24271 Bug Source Folders Sort Java Packages Simple Folders	manifest refactoring list export java output folder delete dialog location
108247 Bug Selected resources scope disabled Enclosing projects	search scope action filter occurrences references selection find element declarations
333541 Bug preferences whitespace characters toggled whitespace characters dialog opened	token pair character painter preview select preference identifier detector java
338656 quick Change type offer matching type type arguments	change type action method add remove proposal modifier processor element
94951 Bug implementation Compiler error prevents development	dialog test ide source annotations annotation indirection constant tests pref
326377 Bug content assist Content assist instantiation adds semicolon wrong place	assist completion proposal content menu field action computer retarget list
120560 Bug implementation Add logging JME accessing Javadoc attached Javadoc	action javadoc type open java info control text browser content
58098 Bug Smart cursor positioning java names don work CONSTANT NAMES	content type string working operation text transfer replacement constant tests
398076 Add test cases bug	reference flow editor test info workspace conditional text cases tests
99072 Bug preferences Explain Ctrl modifier code assistant	type format parameter content activation proposal blank anonymous nested iteration
30468 Bug enhanced smart pasting	action java smart structure command paste indent type change handle
62226 Bug search inline filters menu	action filter call search dialog hierarchy selection view location viewer
381714 Export runnable jar wizard documented	jar manifest file export description refactoring checkbox location error packages
271139 rename button clipped Rename dialog	action wizard input rename refactoring type field label button element
181040 actions removing Create Java Project toolbar	dialog folder action project path output add type wizard container
333631 Bug nls tooling Rename properties key field adds additional	accessor message button field file nls key bundle edit slashes
165689 Bug spell checking enable quick menu	test trace spell table context view action console change assist
143171 Bug misc Update conflicts dialog appears save save longer	save dialog preferred button list manifest field file project checkbox
230222 Bug breadcrumb unfocused dropdown closed leaving workbench window	selection mark java occurrences listener occurrence action folding context breadcrumb
100174 Bug preferences link Java Editor pref honor dialog font	field list radio dialog bracket editor status prop ide annotation
185172 Bug working sets action working selected	action working set model table scope element hierarchy descriptor array
338809 quick bogus Javadoc errors incorrect reference nested type	change type method proposal add remove processor modifier correction declaration
291716 Bug explorer hides jars java resources working selected	set label dialog explorer group action working model selection viewer
239490 working sets explorer Newly created incompatible working sets Explorer	set working element group listener dialog action label project explorer
285573 quick Wrong quickfix proposal operations involving Integer	change remove add proposal type method processor correction modifier quick
82839 Bug misc Breakpoint icons disappear	hover type breakpoint annotation file image warning text app quick
299928 Bug hovering Problem hover Configure Problem Severity project specific Javadoc preferences	configuration preference invalid java comment type dialog hover auto method
231329 decorators decorator methods	label image listener provider range error tick list flat marker
17317 Bug Preference taller screen	completion configuration flag text constant tests change severities add comp
179109 Bug misc Editor computing AST concurrently	operation java transfer wait type reconciling editor active shift hover
275370 Bug toString Generator wrong suffixes prefixes	field string expression dialog extended suffixes prefixes unit matching temporary
55221 Bug Bug comment mapper Grabs node Javadoc	type content node method javadoc tests create selection parameter body
13243 Bug Browsing remains types deleted	action java layout signature delete packages sorting bar unit compilation
432056 javadoc Open Attached Javadoc adapt Javadoc anchor format	action open javadoc control browser content text type listener selection
13269 Bug Incorrect operation order jarpackager	order test sort compilation status project java member cache preference
140248 Bug JUnit support disabled launched	editor scroll java text test
210918 Bug rulers number overview ruler	ruler source parameter text blank action editor type composite java
411636 Bug Save slow burns cycles Project Explorer	clean change remove dialog type add list unused explorer field
51187 Bug content assist filter setters fields	action dialog open setter error fields java selection generate categories
422908 Bug organize imports Add Skip Organize dialog	action dialog open code selection java error wizard format categories
329720 Bug hover preference change background color debug hover popup	listener text java type color hover registry annotation scanner bracket
364539 generate constructor Generate constructor fields globally sets access modifier	action selection dialog open add fields error categories method java
313339 Remove unused internal deprecated code	clean change add remove unused type access unnecessary field code
432132 JUnit test failures AddUnimplementedMethodsTest	java methods unimplemented failures list project add test fragment
99330 Bug implementation Don swallow IllegalStateException ASTprovider	test finder inline save source parser files occurrence project type
443410 RenameTypePerfAcceptanceTests testCold fails	project java
259093 Reverted latest change IntroduceParameterObjectProcessor test failure	test trace table runner action change console view property ens
4121 Bug JarExporter Sync GILQD	refactoring resource progress info undo history descriptor change search resources
111653 Bug misc Dialogs remembering location open correct monitor	filter info refactoring type provider project wizard key editor element
372768 Adjust preference bug	dialog visibility list java completion constant rewrite hierarchy type category
96302 Bug implementation useless statement getAutoEditStrategies	type expression declaration scope method loop buffer binding variable statement
291893 search finegrained search options missing options	rename extension update ual participants field prefix project text erred
178238 quick lightbulb SuppressWarnings quick user configured error	change add correction type method proposal remove processor modifier annotation
317497 Bug content assist Overriding content assist suggestion closing brace generates invalid code	proposal completion computer assist context iteration method template category hint
294970 strings label element	editor key big integer reference tens java digit element style
81983 Bug preferences Disabling enabling folding small file takes	provider java listener preference collapse registry folding element file header
75843 Bug Deadlock arised calling JDIDebugModel createMethodEntryBreakpoint	ruler image editor base descriptor text vertical info size flags
435279 Bug Hover NPE Annotation visible classpath	annotation hover listener type text lines parameter ruler control quick
261198 nodes missing Java Model Synchronize view	text control listener browser unit type java hierarchy context info
298066 Bug nls tooling Refactoring removes comments properties message key	type java parameter root editor key refactoring format test blank
372818 Test failures bug	action test view icon running listener orientation error tests unit
434269 Bug hovering Support showing Javadoc JavaFX properties	type string hover enabled current lines parameter annotation proposal format
43103 Bug RenameType Refactoring detected	detector source hash constant temp decl check build word auto
290916 JUnit Recreate Testsuite uncheck AllTests	tests
23652 Bug Refactor Move doesn handle classes correctly refactoring	action move extract handler type copy convert introduce nested selection
67691 Bug NLS JavaEditor nlsed string job	element type error manager job selection method editor message button
90249 Bug remove workaround code bug	key trigger participant constant instance method tests word window iterator
425109 quick Failures TypeMismatchQuickFixTests IProblem ReturnTypeMismatch	problem ast source java classpath failures set list unit compilation
461999 Bug Warning option argument type collection methods Object bug	variable test string operation add java source property hash object
430267 refactoring extract method Extract Method misses parameter resources statement	refactoring type method change action wizard input rename processor parameter
301242 Bug refactoring clean locked dialogs repeated Undos Java editor	registry preference java file type save hash document text clean
457926 JUnit Update JUnit	test suite selection table dialog classes classpath update button method
49352 Bug typing Smart quotes problem	preference configuration invalid java comment dialog type method auto mark
289992 IResource setDerived IProgressMonitor IResource setDerived	stamp resource marker target files time change listener queries provider
378068 Update ImportOrganizeTest FUP bug bug	rename tests update decl check temp ual text ast project
303313 Test failures SurroundWithTests AllAllRefactoringTests	test failures list setup surround tests
491756 Bug Project Explorer ExtensionState applied	action folder dialog drop explorer project list output build selection
442614 Bug Extract merge string literal escaping	extract variable unit temp change field source selection check constant
262389 Bug Internal code ICompilationUnit applyTextEdit	tests constant nested participant check wait add comp node compilation
290034 Bug Effects SuppressWarnings unchecked broader Eclipse javac	viewer reuse resource call compilation properties map hash content called
283891 JUnit Add camel support TestSelectionDialog	completion test label lass ifies insert ens exec context element
193795 Bug implementation JavadocHover logs incomplete message	test text hover listener annotation browser count quick tif tests
130317 Bug ASTParser IClassFile source creates type bindings isEqualTo binary bindings	type rewrite source test string binding target method change member
371987 quick generated code required type masked local declaration full type	change remove add type method proposal processor modifier correction field
60703 Bug performance Editors longer open editors	editor java test text edit ors auto search performance count
395558 introduce parameter object Introduce Parameter Object introduce type context	action wizard input type rename parameter refactoring field method top
267554 ccp Canceling file copy operation error	jar manifest file export action error description project java source
218431 inline problem fields types	action wizard type input rename refactoring method dialog parameter etter
164162 Bug implementation Memory leak AbstractJavaCompletionProposal synthetic field anonymous	proposal link leak test global context rewrite string refactoring referenced
239940 Bug implementation NPE editing javadoc comment	type format parameter blank unit root indent token string red
88397 Bug OpenAction select ITypeParameter	action open dialog selection message java error wizard add categories
287049 actions Add marks editor unsaved	action call selection add hierarchy location assist view orientation search
231757 Bug implementation NPE JavaEditor handlePreferenceStoreChanged startup	editor java open action viewer change accessor property test source
429399 quick Missing quick IProblem UndefinedName	change add method proposal type remove processor modifier correction create
424283 hovering Support showing Javadoc JavaFX properties	type action hover open enabled current lines parameter annotation java
476517 quick Add unimplemented methods creates stubs methods implementation	action selection dialog open methods add method create error java
287078 Bug content assist Overwrite mode rendered filtering proposals	parameter type format proposal temp completion blank button field formatter
267616 rename Rename method fails create method handle	rename update refactoring hash qualified element test references delegate cached
172388 open type Open Type dialog JRE libraries identical text	action dialog folder add project path type output container open
6503 Bug Search offer sensitivity check box	filter text check radio table button ermediary viewer modifiers overlay
262511 quick Wrong quick fixes type visible	change add type proposal correction method remove processor modifier quick
340338 Bug content assist Proposal replace leading chars selection	completion content proposal current message iteration processor computer assist category
288121 perfs Comments applied performance tests obsolete	type performance methods created binding constraint linked debug ging list
93567 Bug ContextInformationPopup leaks CompletionEngines	leak java add comp undo window text temp constant ast
8581 Bug Search StructuredContentProvider	search key editor java group test constructors hierarchy root fragment
266646 Change CommonDropAdapter method call	refactoring type change method processor constructor rename factory analyzer supported
364947 move method design Move Instance Method refactoring tool doesn match users expectations	refactoring type change method move rename processor constructor analyzer supported
378258 Bug hovering hover variable rich variable hover	hover text control browser listener annotation lines quick tif file
297392 variables removal JDT causing compatibility issues Eclipse	edit variable position dialog button label result selected compilation stored
294322 jar exporter Runnable JAR Export problem special characters included JAR JAR filenames	jar manifest export file description refactoring error packages selection main
251327 browsing JavaBrowsingPart clearing fPreveiousSelectionProvider	action filter viewer layout object list global refresh happened view
347587 explorer Empty parent packages filtered correctly svn folder	label action explorer set java dialog container filters problem project
354766 Bug Javadoc content content assist info window constructors	text browser listener selection completion input current processor content sheet
118222 Bug nls tooling nls tooling java agnostic	test java change search string accessor source development open property
360913 Resource leaks jdt	text test resource java leak undo window descriptor list array
199135 Bug jdt bundle activator assumes PlatformUI getWorkbench causing autobuild failure running headless	test runner save files assumption children status suite element saved
377318 encapsulate field Encapsulate field introduces methods compilation errors	refactoring change type method rename processor constructor analyzer supported move
393719 Bug compiler inconsistent warnings iteration variables	type constraint quick proposal hash manager corrections iteration computer completion
252415 build path Java Project dialog radios parent	list path project dialog add folder status output time button
330241 quick Add unimplemented methods adds methods implementing	action change add type method remove proposal selection processor dialog
17925 Bug References menu item Display KeyTable	listener view item filter viewer menu action annotation ruler trace
408072 nls tooling flagged missing NLS key	source dialog image entry configuration test error type app access
260626 clean Convert loops enhanced clean leaves iterator references	clean add change remove type unused access control field code
396823 JavaModelUtil isPackageInfo ICompilationUnit util applicable	java unit editor document enablement context rewrite test build model
24082 Bug refesh JavaElementSorter	temp decl check constant element add comp comparator ast rewrite
476693 Bug Open declaration jumps wrong method overloaded	parameter type method root source declaration test scope format blank
397842 Bug file incorrect content	temp tests project edit change decl check dot build selection
407056 Support PackageQualifiedType AST node	linked scope type node binding position context declaration info rewrite
256532 Bug templates TemplateProposals API marked deprecated	error type template manager java element selection registry job message
298520 Bug content assist Constructor completion ignores type completing type arguments	change proposal type add method remove processor modifier correction create
307756 Bug compare Compare local history reverts dirty editor	java history compare replace structure action error file selection message
58921 Bug Texts created unsupported styles	list buttons space text button change context document preference group
80455 Bug ITypeBinding canAssign aware type boxing	type scope source declaration flow context root node rewrite file
152142 Bug nls NLS key tab search dialog window	category key type test text preferred java dialog registry arguments
306763 BiDi Copy element labels view BiDi markers	selection dialog action list space compute container root color java
303698 ccp ReorgPolicies canEnable methods	action move group search view generate delegate editor selection binding
243284 inline Inline constant IAE bounds	constant inline action editor refactoring temp method java remove tests
303705 search Custom search hierarchically java search view	search action working scope content java binary view editor set
434791 inline quick assist Delete key work Inline local variable	change type action wizard method add proposal remove input processor
47729 Bug Unable ignore files filters	error manager java filter project dialog type button element status
465521 comparator errors files	checkbox refactoring file manifest export jar files java folders order
162434 Bug content assist Code conpletion doesn choose correct collection	assist proposal quick correction content menu completion action retarget loop
424581 inline Method creating returning lambda statement inlined	refactoring type method change rename processor constructor node supported analyzer
276111 Bug JUnit classpath container doesn pick JUnit jars shared installations	root preference version test unit plugin project build source imported
196242 Bug quick Work QuickFix Latency	change add type proposal method remove correction processor modifier quick
334480 quick create method incorrectly method called method	change method add proposal type remove processor modifier correction create
266924 Bug content assist Broken anonymous type proposals chars caret	proposal context completion java activation iteration registry label position auto
127656 Bug api remove selection IQuickAssistInvocationContext API methods	error manager type element java method message dialog job info
1708 Bug Consistency presentation Display Inspect GJUH	job viewer presenter replacement type semantic string position match text
234170 Bug navigation Java element hyperlink imports declarations	element editor type action file save selection method open changed
324285 Bug JUnit RemoteTestRunnerClient destroys delimiters	buffer delimiters text edit file replace set undo offset length
286406 build path File Java Project identifying source files correctly	file path jar manifest refactoring list status location project java
393932 refactoring pull destination type creates bogus nested type	refactoring type action method change wizard rename input processor move
30412 Bug ClassCastException selecting java browsing perspective	java store workbench shared editor element hierarchy perspective preference window
236251 Bug implementation failure launching headless	test trace table view action console change property development sender
262877 JavaModel object handled JavaNavigatorLabelProvider	label model content property listener problem marker source egete exception
309977 Classpath variable initialization doesn fail silently	structure temp project classpath constraint decl type check arguments variable
253674 clean work preview	clean change remove type add unused save post rewrite field
414444 Bug Configure annotation bundle TYPE	type element clean error add method manager editor selection annotation
125677 Bug navigation category standing outliner	category arguments type menu expression element filter categories preview dialog
25324 Bug Ability tests finished junit	tests test editor indirection scroll log session java text introduce
84724 Bug search fails find call sites varargs constructors	action call search dialog method type field hierarchy constructors selection
308978 JVME exist JavaElementNameComposer appendTypeParameterLabel	test resource quick change initial source project unit fragment java
120572 Bug implementation ISelectionListenerWithAST notified opening explorer	listener content selection dot job explorer build project set descriptor
316155 JUnit View open source test classes fragments	test unit action filter dialog config time label project suite
410371 generalize type Generalize Type adds semantics existing simple names	type tree gray label refactoring map hash editor types valid
35590 Bug JUnit window doesn report errors junit extensions TestSetup JUnit	tests perspective root project src style editor junit set previous
12044 Bug search find constant references files source attached	declaration content jar source rewrite type initializer unit selection references
63250 Bug searching files failes	search unit files test tests factory collected working configuration container
304927 Incorrect Javadoc org eclipse ltk core refactoring Change	extension category change signature edit tal test configuration method based
46875 Bug typing Tabs messed	initial typing count invocation test java text
297752 ccp Pasting copied method pastes method	action creator copy edit selection clipboard type change txt unit
61212 Bug search Search requestor populate Java model	search binary collected working runner constructors array list unit compilation
457515 Bug eclipse JUnit runner hangs Parameters attribute newline	test lass ifies ens exec development unit ables list utions
337707 JUnit JUnitJunitTests depend method ordering	list dialog assumption suite element test path field failed actual
246594 Bug model API request ITypeParameter getBoundsSignatures getSignature	code fallback java editor element resolve match method
164677 Bug EditorMgmt remove IURIEditorInput	quick image annotation listener info warn sep ano save constant
248659 implementation Deleting source folder leaks file handle	refactoring resource delete undo change resources history listener descriptor java
85850 Bug ASTRewrite length TargetSourceRangeComputer removing node list	binding source node selection create methods method created imports declaration
231263 Bug formatter JavaDoc formatter wrongly indent tags description	tab array profile dialog indent java enable format block parameter
195423 Bug content assist computes type hierarchy filtering prefixes	java scanner text completion computer proposal content hierarchy label viewer
387940 quick Add unimplemented methods quickfix add incorrect visibility	change add type method proposal remove action processor modifier create
275308 Bug JUnit RunWith Parameterized don navigate	temp root project tests inline fragment java number test type
369527 Potential NPEs JDT code	change remove type clean add access unused search field post
296836 messages removed ActionMessages	organize filter action editor local hide unit viewer current view
217984 quick assist Wrong type inferred assign local variable	change type remove add proposal method processor modifier correction clean
342926 Bug JUnit DBCS JUnit generate method CJK extension	test unit list launch instance method plugin type config point
411529 move method refactoring reference method	refactoring type change method move rename processor analyzer constructor supported
51092 Bug reconciling JavaMultiPassReconciler removes annotations	java lock reconciling reconcile editor active copy node erred type
184222 Bug templates code templates lock	template registry java preference file hash text provider configuration type
296878 quick Quick adds exception doesn check javadoc element exists	change add type proposal method remove processor correction modifier create
443309 tearDownAfterClass NewTestCaseCreationWizard disabled clicked	dialog action test list buildpath folder filter temp update selection
264112 Bug Formatter Wrap aggressive qualifiers	category profile arguments type preview style expression constructor edit method
81856 Bug quote problems property files JDT	info problems annotation quick image listener problem property list java
90057 Bug nls tooling TVT externalized string Externalize Strings panel	action selection add accessor button dialog key nls field number
424920 Replace References PackageQualifiedType NameQualifiedType	declaration type source result jar references constant rewrite names initializer
474073 Replace valueOf	declaration java initializer names proposal method variable selected unit context
272366 ltk LTK RefactoringWizardOpenOperation opens window window title text	manager refactoring resource initial undo window workbench processor wizard status
68586 Bug implementation Reconciling robust	java listener job semantic reconcile editor reconciling change type unit
333803 move member type Move Type File creates compile error parametrized type	refactoring type change method action wizard rename input processor move
127987 Bug hovering BIDI wrong ordering Hebrew text tooltip code window	status context workspace external selection button operation text insert viewer
201718 Bug content assist Paramter guessing slow	completion assist proposal computer content menu editor list save action
460799 compare Structured compare editor tree doesn properly format qualified types	action type sort jar tree selection label group types changed
47097 Bug content assist Pressing Semicolon commit content assist bypasses smart semicolon	assist proposal completion java format text parameter scanner computer content
411641 Bug content assist Unnecessary content assist popup decimal	assist completion proposal content computer menu processor action retarget list
