334876 quick assist Invert conditions generates incorrect code	 quick assist action statement menu ruler based annotation editor linked
28698 Bug Ctrl outline work file editor read	 editor java element changed selection post action set input read
217126 Bug performance performance tests measure	 measure test performance replace wise create editor refactoring number count
272418 JUnit Support JUnit	 test code comparison source message unit itize prior failure initialize
425006 Bug quick assist Convert anonymous creation creates wildcard type	 type test lambda proposal proposals method action create variable add
304174 hashcode equals Generated equals invalid Object scope	 test create element history relative marker attribute equals mode unit
55349 Bug Delete key Quick Outline text box deletes text editor	 create set selection key outline text preference editor source input
239695 jar exporter export JAR project folder project workspace	 jar export set manifest file folder add java base description
256087 Bug typing Automatically close brace work properly	 test add selected key brace text delete string typing event
331864 JUnit Importing URL trim whitespace skip delimiters	 indent key string word trailing change element label whitespace java
462948 render method content assist adornment	 image context hierarchy label text java set type call bottom
341109 explorer Remove filters Explorer removes filters	 set filter action element view filters selection input viewer add
151668 reorg Copy action add copy prefix	 copy action selection drop destination reorg java elements workbench actions
397447 hovering Code polishing Javadoc hovering feature	 type handle javadoc text doc link drop element content tag
88195 Bug navigation Type search quick outline prefer enclosing type	 outline set action selection type create method element ruler input
53383 Bug incorrect progress message search view	 create key test type java search find browsing method hierarchy
374920 preferences intuitive tab order editor preferences dialog	 preference dialog order create java clean registry store configuration context
437398 ccp Don select extension file paste	 paste type selection action file clipboard element java copy operation
416915 tests tycho surefire plugin	 test doc info perf suite resource tests attached type refactoring
309415 Bug implementation nls tooling DBCS Find Broken Externalized Strings handle constants CJK Ext	 action key accessor editor set string create selection strings file
91306 Bug navigation Java file opens text selected	 file text create accessor dialog focus test set key error
81078 Bug preferences Restore Defaults duplicates list entries	 preference list create dialog container members classpath formatter preferences status
385237 move member type Moving member file adds host type parameters	 type method create set member check declaration handle javadoc target
479440 rename rename options links hover	 test rename create control input file text check binding element
42208 Bug Source hover affordance text black	 hover control annotation text binding java input source info content
66787 Bug Wrong capitalized filters message search	 filter filters search type set match add create text item
332008 quick Quick improved mixed projects	 quick correction image assist marker annotation processor meter problem collect
46332 Bug Jobs longer responsive pressing ctrl	 element java viewer post refresh update lines runs resource changed
318731 perfs Comments applied JDT performance tests obsolete	 measure insert create set perf performance test replace measurements runs
81172 Bug spell checking preferences Spell checking works report problems type enabled	 spell proposal threshold single dictionary check ignore word problem assist
82204 Bug key binding Shortcut Open Declaration doesn context menu Java Editor	 action perform editor context java input selection set preference changed
102696 quick Quick fail update method comment	 quick action test image editor unit proposal menu ruler fill
9517 Bug Browser Perspective project doesn project view	 selection java create type set input editor source javadoc action
153912 common navigator Java model hiding parent folders sync view	 action java add resource create children context label viewer set
398648 Javadoc View inserts wrong asterisk link linebreak	 selection type set create action element link text javadoc add
43332 Bug String Substitution Support org eclipse core variables	 accessor create check key substitution file button source add field
232773 working sets Assign Working pre fill selected elements	 working set create selection project scope add action selected element
129354 Bug Keybinding focus javadoc editor	 action selection create set input text focus editor menu dialog
466252 Bug templates template block	 template context preference type dialog create viewer changed project code
477523 Provide severity level	 create hierarchy helper input add status refactoring element set validation
259413 refactoring Handler conflicts refactoring previews	 refactoring change context perform element descriptor exception create dialog progress
312659 Remove unused NLS	 unused remove variable side clean statement rewrite create declaration code
53603 search search view expand collapse actions	 set action view call hierarchy method history search input add
43364 Bug typing insertion wrong	 typing event text listener key selection focus change test offset
70005 content assist Missing Getter Setter code assist proposals	 proposal assist context proposals set content create completion session text
186754 Bug explorer context menu empty selection	 set action view selection element add input create viewer update
320916 Bug preferences Content Assist Advanced Read description entry fields	 create setter selection set dialog button fields configuration preference entry
222609 Bug misc adopt schema identifier PDE	 test create exception tree completion proposal computer filtering java registry
313751 typo modfier code	 status entry position event whitespace delegate matching type paren selection
215448 working doesn Working List	 working set element create selection add test changed button drop
199064 Bug dnd Element reordering DnD format field comments	 set drop view drag selection call input transfer history hierarchy
90528 Bug Editor icon problem decoration instance	 create java annotation preference editor problem set problems test changed
279981 Constructor inlining produces illegal result	 test constructor type project factory multi unit set arguments create
480682 Bug override method offer override implement method	 method proposal methods create code declaration tree content rewrite override
252340 clean Clean infrastructure minor documentation issues	 clean test code set options number proposal create tab settings
70079 Bug rulers override indicators anonymous classes	 test method anonymous type hierarchy perform call names create expression
59845 Bug performance Opening file editor compute overriding indicators	 measure test editor override text open runs hold number background
306646 Bug painting Print margin differentiate file type	 test type helper tests temp method expected rename instance replace
320983 hovering Javadoc display properly classes type HTML element	 type javadoc create selection set drop element link label parameter
49619 Bug formatting comment formatter leaves whitespace comments	 indent create java test formatter format preview preference lines empty
233941 Bug ltk Refactoring history workspace refactorings year	 refactoring history pattern set context accept descriptor label time delete
30169 Bug hover message bookmarks overview ruler	 set create annotation input ruler hover java selection outline source
255448 preferences Code Style preference single selection table	 create preference set selection update focus key dialog filter list
344552 Bug Source tabs cleared project closed	 test project indent selection create ruler java unit element action
59891 Bug formatter improve lines wrapping nested method calls	 test create map preview update wrapping style indent text set
14837 Bug Java Search actions shouldn enabled folder selected packages view	 set action create input view selection element editor viewer type
421383 Bug Graphics Scaling issues high DPI displays	 task dialog test create move set type viewer field image
144902 Bug navigation Explorer	 test set action focus text view explorer selection navigation files
35339 Bug inheritedoc consistently rendered	 image link type element text color key label change attribute
396808 hovering hovering multiple hyperlinks multiple location build path	 source entry dialog list drop set selection create elements path
52750 Bug correct indentation messes comment boxes	 indentation test indent create java method format lines alignment type
396809 hovering Write JUnits hovering feature	 action drop set selection operation references servlet java buffer target
252432 render API JDT Core provide display referenced jars	 label file java path jar search post content element styled
329252 preferences content assist Auto activation delay mention unit time	 completion context assist create text set preference processor change field
329248 ltk file folder exist empty input resource rename dialog	 test delete refactoring file project rename resource folder change check
13877 Bug NLS tool values displayed correctly	 set action create selection menu update input property modifier project
67124 Bug ccp dnd Minor Copy Paste issues	 action selection copy type drop paste operation clipboard target java
165434 Bug Structure Viewers Reconcile structure document	 set ion structure create java test collapse document element problem
178744 Bug misc Editor opened sync resource refresh action	 set editor input action create view selection method element java
79419 Bug Preferences link component	 create add preference project property selection changed link java check
52801 Bug Press focus work spell checking hovers	 spell text hover dictionary check control sentence single proposal info
108115 Bug refactoring Extract Local Variable Constant don find matching invocations methods	 descriptor create check temp variable refactoring test expression guess set
133731 Bug Field Assist Platform define preferences content assist colors	 create text assist context preference field test registry content set
13921 Bug Desire project property settings Ant integration	 set javadoc jar ant project path launch selection base create
19043 Bug Config dialog Generate Doc Wizard bad	 javadoc create method string button dialog builder template check unit
274023 Bug build path nested source folder build path rendered lib icon	 path test project folder action set update element container dialog
38499 Bug Source Hover oszillates	 annotation hover source ruler java text info test content doc
64108 Bug Javadoc keywords settings longer work Java Editor	 set javadoc selection indent type java path create action image
62062 Bug Mark Occurrences annotation text interesting Tooltip Description	 occurrences create set selection mark outline editor preference ruler action
47731 Bug JUnit view leaks Colors	 test image random label undo path unit view workbench trace
28277 Bug clicking Types view refreshes decorators	 hierarchy viewer view type set changed update input element create
211578 Bug build path Dialog extend classpath variable slow	 path dialog entry project update element set selection list container
312966 Bug hovering text Javadoc hover view visible Ubuntu	 set control hover selection input action java color style text
421506 Bug Suggestion align Additional Save actions desired code Eclipse contribution guidelines	 create preference menu context file java folder registry set text
37513 Bug misc Outline tool window remember size position	 set create action selection outline element key input position property
492173 Bug Missing styling Java project wizard	 test path classpath set editor element java string create list
304792 move method Move single function interfaces work	 test selection move method create changed selected conditions user text
32412 Bug ccp progress monitor rename prompt copy pasting file	 set create test annotation file java save rename problems document
126625 Bug missing options formatting annotation types	 type override method problem string test set indent number indentation
330415 inline Refactor Inline fails parenthesize replaced arguments	 descriptor create action menu test refactoring method quick extract selection
12996 Bug open multipage editor Invalid thread access exporting jar	 selection java jar key set create action type dialog active
19145 Bug Wizards wizards resizable bounds	 dialog button entry list attachment pattern inclusion create path hierarchy
312014 content tree view projects folders export jar read screen readers	 set jar export create file manifest refactoring java handle description
244431 preferences Outgoing change preferences change	 preference create label project add property java scanner link listener
24271 Bug Source Folders Sort Java Packages Simple Folders	 set create destination elements source java move jar packages copy
108247 Bug Selected resources scope disabled Enclosing projects	 test scope search text create java change children projects project
333541 Bug preferences whitespace characters toggled whitespace characters dialog opened	 test create escape set token preview check scanner java wise
338656 quick Change type offer matching type type arguments	 method type proposal proposals lambda check parameter members action variable
94951 Bug implementation Compiler error prevents development	 test dialog create type button annotation helper annotations field configuration
326377 Bug content assist Content assist instantiation adds semicolon wrong place	 assist content field context create test history set menu iteration
120560 Bug implementation Add logging JME accessing Javadoc attached Javadoc	 javadoc type action handle doc input selection exception set text
58098 Bug Smart cursor positioning java names don work CONSTANT NAMES	 type set test handle constant text names create add input
398076 Add test cases bug	 test session flow find method lass tree send ifies tests
99072 Bug preferences Explain Ctrl modifier code assistant	 editor text create content context set assist test activation java
30468 Bug enhanced smart pasting	 test paste smart java element diff brace indent auto set
62226 Bug search inline filters menu	 set view action input selection create viewer filter filters menu
381714 Export runnable jar wizard documented	 set jar export manifest refactoring create description file java widget
271139 rename button clipped Rename dialog	 create rename selection element input check setter button accessor update
181040 actions removing Create Java Project toolbar	 action create set filter buildpath handle viewer list element history
333631 Bug nls tooling Rename properties key field adds additional	 key accessor create selection button change search nls property check
165689 Bug spell checking enable quick menu	 spell dictionary problem test word table sentence menu proposal event
143171 Bug misc Update conflicts dialog appears save save longer	 dialog save create update button set file jar selected element
230222 Bug breadcrumb unfocused dropdown closed leaving workbench window	 create editor selection action breadcrumb set menu test ruler outline
100174 Bug preferences link Java Editor pref honor dialog font	 create dialog button add test preference configuration validate list field
185172 Bug working sets action working selected	 working action set create element checked search model selection dialog
338809 quick bogus Javadoc errors incorrect reference nested type	 type proposal proposals lambda method add create variable constructor convert
291716 Bug explorer hides jars java resources working selected	 set working element create selection selected action test java dialog
239490 working sets explorer Newly created incompatible working sets Explorer	 set working element create selection add project selected drop group
285573 quick Wrong quickfix proposal operations involving Integer	 test quick proposal correction assist image string proposals preview type
82839 Bug misc Breakpoint icons disappear	 image breakpoint java ruler annotation icon event set action hover
299928 Bug hovering Problem hover Configure Problem Severity project specific Javadoc preferences	 preference problems label changed annotation problem status specific ticks project
231329 decorators decorator methods	 label hierarchy problems changed text image annotation java source ticks
17317 Bug Preference taller screen	 test type method preference action constant java perform link parameter
179109 Bug misc Editor computing AST concurrently	 set window operation imports selection editor type text control java
275370 Bug toString Generator wrong suffixes prefixes	 type method names expression create field template dialog string comment
55221 Bug Bug comment mapper Grabs node Javadoc	 type create parameter method set handle tag javadoc field add
13243 Bug Browsing remains types deleted	 test delete create add element source action browsing file type
432056 javadoc Open Attached Javadoc adapt Javadoc anchor format	 type javadoc action selection handle input text doc create classpath
13269 Bug Incorrect operation order jarpackager	 test imports add type unresolvable jar action star names remove
140248 Bug JUnit support disabled launched	 test wise session editor scroll message itize prior send launched
210918 Bug rulers number overview ruler	 input create ruler editor set annotation source text mouse viewer
411636 Bug Save slow burns cycles Project Explorer	 set clean test change create project element files dialog changed
51187 Bug content assist filter setters fields	 set create setter assist selection proposals getter fields content completion
422908 Bug organize imports Add Skip Organize dialog	 test imports create clean type organize unresolvable settings preference java
329720 Bug hover preference change background color debug hover popup	 preference java control color create initialize annotation set registry hover
364539 generate constructor Generate constructor fields globally sets access modifier	 action create selection constructor fields editor check generate menu fill
313339 Remove unused internal deprecated code	 unused test clean remove code variable options side rewrite statement
432132 JUnit test failures AddUnimplementedMethodsTest	 test description failures methods tests create suite unimplemented action java
99330 Bug implementation Don swallow IllegalStateException ASTprovider	 test save perform inline reference expression field type start method
443410 RenameTypePerfAcceptanceTests testCold fails	 perf test rename finish measurements move compilation eptance unit members
259093 Reverted latest change IntroduceParameterObjectProcessor test failure	 test failure status random undo set children change poisson refactoring
4121 Bug JarExporter Sync GILQD	 image set type search history job add progress resource create
111653 Bug misc Dialogs remembering location open correct monitor	 type set project search item selection text path create match
372768 Adjust preference bug	 set visibility test field method constant container type project path
96302 Bug implementation useless statement getAutoEditStrategies	 test type expression statement method flow field loop perform inline
291893 search finegrained search options missing options	 test source add path search proposal version rename clean file
178238 quick lightbulb SuppressWarnings quick user configured error	 annotation set quick assist marker create problem problems image save
317497 Bug content assist Overriding content assist suggestion closing brace generates invalid code	 context compute assist content create text completion session iteration selection
294970 strings label element	 label create type string pattern parameter key selection styled strings
81983 Bug preferences Disabling enabling folding small file takes	 ion java preference create collapse context element registry provider workbench
75843 Bug Deadlock arised calling JDIDebugModel createMethodEntryBreakpoint	 image refactoring check history add breakpoint descriptor element bottom execution
435279 Bug Hover NPE Annotation visible classpath	 annotation set hover control color mouse viewer ruler item size
261198 nodes missing Java Model Synchronize view	 add type set action selection missing create input parent annotation
298066 Bug nls tooling Refactoring removes comments properties message key	 key test create result file input property check search change
372818 Test failures bug	 test set action create failures session view launch description title
434269 Bug hovering Support showing Javadoc JavaFX properties	 drop set java type buffer proposal selection viewer print tag
43103 Bug RenameType Refactoring detected	 test word source constant helper code string status temp guess
290916 JUnit Recreate Testsuite uncheck AllTests	 
23652 Bug Refactor Move doesn handle classes correctly refactoring	 action members drop copy menu type set refactoring method create
67691 Bug NLS JavaEditor nlsed string job	 type set search history job progress messages info positions update
90249 Bug remove workaround code bug	 signature focus test set receiver type method text selection path
425109 quick Failures TypeMismatchQuickFixTests IProblem ReturnTypeMismatch	 proposal problem unit ignore annotation preview type proposals add number
461999 Bug Warning option argument type collection methods Object bug	 test perform type helper reference expression method field inline suppress
430267 refactoring extract method Extract Method misses parameter resources statement	 create descriptor test method check set type expression selection parameter
301242 Bug refactoring clean locked dialogs repeated Undos Java editor	 test bug preference clean java create workbench change registry error
457926 JUnit Update JUnit	 test suite create classpath method unit type update set selection
49352 Bug typing Smart quotes problem	 test brace indent auto smart listener add create method semicolon
289992 IResource setDerived IProgressMonitor IResource setDerived	 resource drag create change history refactoring progress undo model handle
378068 Update ImportOrganizeTest FUP bug bug	 test helper type rename method expected tests update field create
303313 Test failures SurroundWithTests AllAllRefactoringTests	 test exception failures method initializer description output create resource unit
491756 Bug Project Explorer ExtensionState applied	 test completion set project selection create output action java element
442614 Bug Extract merge string literal escaping	 test type create field constant escaping set check declaration node
262389 Bug Internal code ICompilationUnit applyTextEdit	 test type project create path helper file constant source compliance
290034 Bug Effects SuppressWarnings unchecked broader Eclipse javac	 map call viewer member list resource items file unit text
283891 JUnit Add camel support TestSelectionDialog	 test add method prefix proposal classpath failed guessing auto context
193795 Bug implementation JavadocHover logs incomplete message	 test selection set element action failure exception create browser time
130317 Bug ASTParser IClassFile source creates type bindings isEqualTo binary bindings	 method type test target create check set source argument search
371987 quick generated code required type masked local declaration full type	 type proposal create method proposals lambda statement local parameter convert
60703 Bug performance Editors longer open editors	 editor number measure test key meter input count activate annotation
395558 introduce parameter object Introduce Parameter Object introduce type context	 create refactoring descriptor action start parameter menu type input method
267554 ccp Canceling file copy operation error	 create set input annotation file drop project action save copy
218431 inline problem fields types	 type proposal find property method preview field fields ignore context
164162 Bug implementation Memory leak AbstractJavaCompletionProposal synthetic field anonymous	 test proposal validation set change field search link string reference
239940 Bug implementation NPE editing javadoc comment	 create doc java type preference buffer content javadoc helper color
88397 Bug OpenAction select ITypeParameter	 action test set selection key create hyperlinks text select hyperlink
287049 actions Add marks editor unsaved	 action editor menu set view selection call add history method
231757 Bug implementation NPE JavaEditor handlePreferenceStoreChanged startup	 test post editor changed element comment source create accessor preference
429399 quick Missing quick IProblem UndefinedName	 annotation proposal create problem unit problems set save add ignore
424283 hovering Support showing Javadoc JavaFX properties	 action selection set drop type operation viewer create java target
476517 quick Add unimplemented methods creates stubs methods implementation	 create action methods selection editor type constructors method rewrite changed
287078 Bug content assist Overwrite mode rendered filtering proposals	 create completion set proposal assist parameter compute context sort field
267616 rename Rename method fails create method handle	 type rename method create test set check element refactoring update
172388 open type Open Type dialog JRE libraries identical text	 dialog selection list open element entry create container path external
6503 Bug Search offer sensitivity check box	 create set input update add text filter preference validate dialog
262511 quick Wrong quick fixes type visible	 quick correction proposal proposals image assist type preview marker ignore
340338 Bug content assist Proposal replace leading chars selection	 context assist add proposal create set completion test javadoc content
288121 perfs Comments applied performance tests obsolete	 measure type constraints performance create insert set replace test compute
93567 Bug ContextInformationPopup leaks CompletionEngines	 test editor random undo constant breadcrumb guess poisson listener code
8581 Bug Search StructuredContentProvider	 search constructor references key pattern method scope test match node
266646 Change CommonDropAdapter method call	 set type change internal method refactoring factory selection search create
364947 move method design Move Instance Method refactoring tool doesn match users expectations	 method target type set create selection argument move refactoring check
378258 Bug hovering hover variable rich variable hover	 hover text selection action input control browser type binding set
297392 variables removal JDT causing compatibility issues Eclipse	 variable dialog create button proposal variables edit context position method
294322 jar exporter Runnable JAR Export problem special characters included JAR JAR filenames	 jar set manifest export file description refactoring source files java
251327 browsing JavaBrowsingPart clearing fPreveiousSelectionProvider	 input create action element viewer set post object display read
347587 explorer Empty parent packages filtered correctly svn folder	 element set input selection text test update action post create
354766 Bug Javadoc content content assist info window constructors	 selection create java completion text action content proposals set browser
118222 Bug nls tooling nls tooling java agnostic	 test text context java tag classpath launch buffer nls type
360913 Resource leaks jdt	 test editor resource random undo java property breadcrumb context poisson
199135 Bug jdt bundle activator assumes PlatformUI getWorkbench causing autobuild failure running headless	 test failure save status set tree suite editor children session
377318 encapsulate field Encapsulate field introduces methods compilation errors	 test create setter field getter method access set check refactoring
393719 Bug compiler inconsistent warnings iteration variables	 type method test field element create context set invalid assist
252415 build path Java Project dialog radios parent	 project path folder java element entry dialog classpath container update
330241 quick Add unimplemented methods adds methods implementing	 action methods editor selection test create type rewrite impl proposal
17925 Bug References menu item Display KeyTable	 set item action viewer menu control view event filter focus
408072 nls tooling flagged missing NLS key	 set image attribute test classpath encoded element string messages path
260626 clean Convert loops enhanced clean leaves iterator references	 test clean bug code convert remove block rewrite members loop
396823 JavaModelUtil isPackageInfo ICompilationUnit util applicable	 type java method test create action selection compute completion replacement
24082 Bug refesh JavaElementSorter	 test helper temp constant guess path code element references guessed
476693 Bug Open declaration jumps wrong method overloaded	 test method type create parameter check set declaration inline perform
397842 Bug file incorrect content	 test helper tests method temp search refactoring init file erencing
407056 Support PackageQualifiedType AST node	 method declaration node type arguments check call linked methods binding
256532 Bug templates TemplateProposals API marked deprecated	 java context template preference registry workbench type file exception element
298520 Bug content assist Constructor completion ignores type completing type arguments	 proposal completion method context compute type core javadoc java create
307756 Bug compare Compare local history reverts dirty editor	 editor java edit action text changed compare modifier replace highlight
58921 Bug Texts created unsupported styles	 create selection string style method styling parameter viewer list set
80455 Bug ITypeBinding canAssign aware type boxing	 type method declaration variable binding test find parameter field argument
152142 Bug nls NLS key tab search dialog window	 create key java preference test update dialog button selection map
306763 BiDi Copy element labels view BiDi markers	 label container set create dialog selection input list action text
303698 ccp ReorgPolicies canEnable methods	 action selection move create methods selected actions context refactoring java
243284 inline Inline constant IAE bounds	 descriptor create constant selection refactoring java method extract type inline
303705 search Custom search hierarchically java search view	 search action set scope working tree context remove current elements
434791 inline quick assist Delete key work Inline local variable	 descriptor create check method refactoring test type source delete extract
47729 Bug Unable ignore files filters	 filter filters set action dialog root view build file changed
465521 comparator errors files	 file jar set export manifest create java refactoring files description
162434 Bug content assist Code conpletion doesn choose correct collection	 test assist generate content set quick proposal create context param
424581 inline Method creating returning lambda statement inlined	 test method type lambda create proposal proposals add reference statement
276111 Bug JUnit classpath container doesn pick JUnit jars shared installations	 test classpath source output unit add project launch container entries
196242 Bug quick Work QuickFix Latency	 quick test assist marker image correction java create collect problem
334480 quick create method incorrectly method called method	 refactoring method set element call impl type validation rewrite create
266924 Bug content assist Broken anonymous type proposals chars caret	 proposal context create completion type set javadoc assist method core
127656 Bug api remove selection IQuickAssistInvocationContext API methods	 proposal receiver type method path selection test fail invocation assist
1708 Bug Consistency presentation Display Inspect GJUH	 set create type viewer completion style offset element document java
234170 Bug navigation Java element hyperlink imports declarations	 type key hyperlink element rewrite open hierarchy match scope imports
324285 Bug JUnit RemoteTestRunnerClient destroys delimiters	 document test random buffer set undo delimiters text changed poisson
286406 build path File Java Project identifying source files correctly	 set jar file export project path java create manifest build
393932 refactoring pull destination type creates bogus nested type	 action check type create method members set pull selection member
30412 Bug ClassCastException selecting java browsing perspective	 java perspective type create javadoc editor input browsing wise working
236251 Bug implementation failure launching headless	 test failure execution launch classpath set arguments change menu main
262877 JavaModel object handled JavaNavigatorLabelProvider	 set button list element label marker message changed type checked
309977 Classpath variable initialization doesn fail silently	 structure test type project create set temp container element variables
253674 clean work preview	 clean preference set preview create options register selected changed res
414444 Bug Configure annotation bundle TYPE	 image java ruler annotation set quick bundle element test managed
125677 Bug navigation category standing outliner	 set create selection categories preview text category element update map
25324 Bug Ability tests finished junit	 test session tree wise swap result listener editor scroll ended
84724 Bug search fails find call sites varargs constructors	 constructor search method type set action selection call list hierarchy
308978 JVME exist JavaElementNameComposer appendTypeParameterLabel	 test delete lambda resource file create bug change condition folder
120572 Bug implementation ISelectionListenerWithAST notified opening explorer	 test listener selection text set frame unit root provider source
316155 JUnit View open source test classes fragments	 test suite type selection set classes unit method open widget
410371 generalize type Generalize Type adds semantics existing simple names	 test type descriptor create selection local refactoring field parametric parameter
35590 Bug JUnit window doesn report errors junit extensions TestSetup JUnit	 test project hierarchy open set perf workspace editor java element
12044 Bug search find constant references files source attached	 type handle method constant java test doc find source references
63250 Bug searching files failes	 test file set search project unit path create refactoring matches
304927 Incorrect Javadoc org eclipse ltk core refactoring Change	 refactoring create change type descriptor declaration resource validation container method
46875 Bug typing Tabs messed	 typing configuration add create auto test mode smart overlay display
297752 ccp Pasting copied method pastes method	 test clipboard type change edit action create java resources set
61212 Bug search Search requestor populate Java model	 search set type matches method find test editor status match
457515 Bug eclipse JUnit runner hangs Parameters attribute newline	 test description classpath launch failed arguments main failures entry execution
337707 JUnit JUnitJunitTests depend method ordering	 test failure set tree list suite session ordering description range
246594 Bug model API request ITypeParameter getBoundsSignatures getSignature	 type element link test create variable handle proposal java descriptor
164677 Bug EditorMgmt remove IURIEditorInput	 test bug remove problems annotation set save create add code
248659 implementation Deleting source folder leaks file handle	 refactoring add source history delete remove set resource java change
85850 Bug ASTRewrite length TargetSourceRangeComputer removing node list	 type create method add constructor node parameter edit variable field
231263 Bug formatter JavaDoc formatter wrongly indent tags description	 indent create preference tab java add test formatter javadoc empty
195423 Bug content assist computes type hierarchy filtering prefixes	 set content assist context create hierarchy type text filter exception
387940 quick Add unimplemented methods quickfix add incorrect visibility	 create action constructors editor selection test methods constructor type rewrite
275308 Bug JUnit RunWith Parameterized don navigate	 test match editor description temp session tree java element evil
369527 Potential NPEs JDT code	 merge access type label potential change participant compute create proposal
296836 messages removed ActionMessages	 action selection open external bar type organize imports java editor
217984 quick assist Wrong type inferred assign local variable	 proposals proposal type statement variable lambda method expression add merge
342926 Bug JUnit DBCS JUnit generate method CJK extension	 test path type image unit tests names method workbench receiver
411529 move method refactoring reference method	 method type create member check declaration set target java move
51092 Bug reconciling JavaMultiPassReconciler removes annotations	 window set reconciling java indicator reconcile editor overlaid type requestor
184222 Bug templates code templates lock	 template preference registry java context workbench text file instance store
296878 quick Quick adds exception doesn check javadoc element exists	 quick assist correction proposal proposals marker java test preview meter
443309 tearDownAfterClass NewTestCaseCreationWizard disabled clicked	 test create set temp selection refactoring classpath dialog helper action
264112 Bug Formatter Wrap aggressive qualifiers	 create indent profile test preview dialog add map update preference
81856 Bug quote problems property files JDT	 file create set annotation type problems problem java add save
90057 Bug nls tooling TVT externalized string Externalize Strings panel	 create accessor key action selection button set check editor table
424920 Replace References PackageQualifiedType NameQualifiedType	 constant type check set method create text declaration references expression
474073 Replace valueOf	 proposal create set constant check declaration type replace method initializer
272366 ltk LTK RefactoringWizardOpenOperation opens window window title text	 refactoring create wizard initial resource selection message user status manager
68586 Bug implementation Reconciling robust	 reconciling java changed window reconcile literal positions set editor text
333803 move member type Move Type File creates compile error parametrized type	 method type create set check members member target refactoring destination
127987 Bug hovering BIDI wrong ordering Hebrew text tooltip code window	 dialog create text java set editor selection viewer change changed
201718 Bug content assist Paramter guessing slow	 completion create category context proposal clean changed content assist set
460799 compare Structured compare editor tree doesn properly format qualified types	 type element selection tree set input add action java viewer
47097 Bug content assist Pressing Semicolon commit content assist bypasses smart semicolon	 text content completion assist create test method compute comment java
411641 Bug content assist Unnecessary content assist popup decimal	 content text assist context test create java history set iteration
