36800 Bug find replace Find Replace dialog retain previous Replace text	 set color test format layout text create writer time request
41156 log threads reasonable names	 test facility set string stack time tag dump print prior
41476 Bug CVS Repository Explorer fails filename colon character	 test set parse file pattern top logger element rolling appender
32582 Bug logical physical mapping problem model element Files problem	 set parse element test appender layout format document table start
46983 Bug Generalize type meaning grey tree entries	 test set top check file rolling error layout throwable logger
49812 Bug Choosing bean component palette takes time	 bean appender notification dynamic table add register property count current
44386 Bug Bookmarks bookmark single click	 test set appender bad trace debug string pattern info log
42281 Unit tests fail java gcj JRockit	 test set facility top check appender layout throwable rollover queue
43113 Move log branch log trunk	 pattern set debug log error converter info trace arg string
42283 Eclipse Java compiler warnings usused imports members serializationUID	 set appender file pattern test add key parse logger renderer
49003 Bug Move members open reveal moved method refactoring	 set test pattern appender error file logger buffer add log
40951 log release	 set string server layout log syslog facility appender info trace
41219 Stacktraces exceptions disappear occsionally	 set pattern test buffer writer layout expected stack entry appender
48784 Links code broken JavaDocs	 set appender level renderer add object logger log period check
45982 Support layout specification output MDC key pairs	 key set pattern parse logger object property location event time
34874 Bug Context menu IJavaVariable IJavaInspectExpression IJavaWatchExpression	 set test throwable layout event check format topic context file
37182 Exception exception toString log fail	 test set appender check topic layout queue threshold binding table
50238 Bug implementation install InformationPresenter uninstall	 test set appender logger pattern file error bad rolling threshold
45636 tests DateLayout failing ill initialized DateFormat	 format test set option layout time expected pattern position val
17862 Version getVersion method requested	 set method cached server request time location format buffer key
41565 Timezone specifier pattern layout reported work	 format set pattern test layout time expected converter option buffer
44644 ContentType Layout text html	 test request set dialog expected file problem create handle layout
28647 Add Flush Level capability FileAppender	 test set appender event logger add file error threshold trace
46574 Bug Unabled collect object reference properly	 appender set test event remove renderer thread writer location map
50287 Bug EditorMgmt Support opening external editor IStorageEditorInput	 set test file logger appender key throwable server property category
42099 ExpressionFilter backport	 
35831 log build JDK	 bean notification appender dynamic info register layout add logger fqn
42108 LoggingEvent accessors compatible log	 test pattern size cell table event buffer count location deserialization
