36800 Bug find replace Find Replace dialog retain previous Replace text	text time writer pub log string lishing print parent num
41156 log threads reasonable names	bean gram names time num enabled appenders mode cat quiet
41476 Bug CVS Repository Explorer fails filename colon character	file method pattern info time writer logger rolling policy factory
32582 Bug logical physical mapping problem model element Files problem	output multicast logger factory appender list table handler icon pattern
46983 Bug Generalize type meaning grey tree entries	file log time rolling policy msg handler itivity jdbc simple
49812 Bug Choosing bean component palette takes time	bean broadcaster table attributes parent logger pattern descriptor repository property
44386 Bug Bookmarks bookmark single click	file policy trace writer print add itivity etitions rep pattern
42281 Unit tests fail java gcj JRockit	queue factory context add itivity url provider logging event binding
43113 Move log branch log trunk	log pattern monitor msg handler string jdbc error enabled literal
42283 Eclipse Java compiler warnings usused imports members serializationUID	file size ted renderer dir rolling logger repository roll time
49003 Bug Move members open reveal moved method refactoring	pattern file log database buffer info policy fered msg handler
40951 log release	monitor host facility syslog output buffer header multicast appender attachable
41219 Stacktraces exceptions disappear occsionally	pattern database info convert event handles handler foo error type
48784 Links code broken JavaDocs	renderer logger file level time fered ted appender attachable simple
45982 Support layout specification output MDC key pairs	pattern lookup set logger info time method copy mdc key
34874 Bug Context menu IJavaVariable IJavaInspectExpression IJavaWatchExpression	lookup pane binding queue topic info method security file policy
37182 Exception exception toString log fail	binding topic queue security gram pkg url factory connection syslog
50238 Bug implementation install InformationPresenter uninstall	file policy add urator itivity repository etitions selector rep config
45636 tests DateLayout failing ill initialized DateFormat	time format printing pref start zone string field logging position
17862 Version getVersion method requested	method info set multicast location server monitor buffer writer string
41565 Timezone specifier pattern layout reported work	pattern database buffer format zone time handles millisecond sql array
44644 ContentType Layout text html	file type uting comp server parent string foo path ignores
28647 Add Flush Level capability FileAppender	file event output multicast fered add uting pattern comp conf
46574 Bug Unabled collect object reference properly	appender event renderer map attachable parent logger buffer rep info
50287 Bug EditorMgmt Support opening external editor IStorageEditorInput	file lookup logger buffer info fered policy multicast time server
42099 ExpressionFilter backport	
35831 log build JDK	method info broadcaster writer bean attributes trace logger repository visual
42108 LoggingEvent accessors compatible log	pattern num list table image max icon size logging buffer
