36800 Bug find replace Find Replace dialog retain previous Replace text	set color test format time layout text writer pub create
41156 log threads reasonable names	test facility set time string stack names tag debug gram
41476 Bug CVS Repository Explorer fails filename colon character	test set parse file pattern top logger appender rolling element
32582 Bug logical physical mapping problem model element Files problem	set parse element test appender layout format document table add
46983 Bug Generalize type meaning grey tree entries	test set top check file rolling error layout throwable format
49812 Bug Choosing bean component palette takes time	bean appender notification dynamic property table add register count layout
44386 Bug Bookmarks bookmark single click	test set appender bad trace debug string pattern info log
42281 Unit tests fail java gcj JRockit	test set facility top queue check appender layout throwable rollover
43113 Move log branch log trunk	pattern log set debug error converter info array trace arg
42283 Eclipse Java compiler warnings usused imports members serializationUID	set file appender pattern test add rolling max key logger
49003 Bug Move members open reveal moved method refactoring	set test pattern appender file log logger buffer error add
40951 log release	set string log trace syslog layout appender facility info header
41219 Stacktraces exceptions disappear occsionally	pattern set test buffer writer layout expected stack entry appender
48784 Links code broken JavaDocs	set appender add level renderer file object logger log period
45982 Support layout specification output MDC key pairs	pattern set key parse logger throwable object property lookup event
34874 Bug Context menu IJavaVariable IJavaInspectExpression IJavaWatchExpression	set test throwable queue layout event check format lookup context
37182 Exception exception toString log fail	test set appender queue check layout topic threshold table element
50238 Bug implementation install InformationPresenter uninstall	test set appender logger pattern file error bad rolling threshold
45636 tests DateLayout failing ill initialized DateFormat	format test set time option layout expected pattern position val
17862 Version getVersion method requested	method set time cached request info buffer server location output
41565 Timezone specifier pattern layout reported work	format set pattern time test layout expected converter option buffer
44644 ContentType Layout text html	test request set file expected dialog problem create layout handle
28647 Add Flush Level capability FileAppender	test set file appender event logger add pattern error threshold
46574 Bug Unabled collect object reference properly	appender set test event remove renderer thread writer location map
50287 Bug EditorMgmt Support opening external editor IStorageEditorInput	set test file logger throwable appender key property server lookup
42099 ExpressionFilter backport	
35831 log build JDK	bean info notification method dynamic appender register logger string writer
42108 LoggingEvent accessors compatible log	test pattern size cell table event num buffer count icon
