33806 Bug Code assist failure assignment loop hides previous variables	flow variables cache options exception manager count node container types
23573 Bug AST clone source locations	build type set reference binding search hash project resource scratch
405038 Bug formatter infix expression formatting broken spaces binary	wrap formatter indent width info event store erred measuring tenance
383046 compiler Error reported lambda expression subsequent parse error	error stack element method block node paren length ptr expression
152135 Bug breakpoints Hovering conditional breakpoint condition	type init expression property flow thread virtual code constant optimized
178760 Bug Copy Paste mechanism work	javac java eclipse elements test error bug type awaiting pivot
405069 compiler codegen Generate code method references	synthetic binding source max receiver type write code references bindings
234074 Bug Compliance test fails launched JRE Dcompliance	javac path eclipse java error test bug pivot virtual options
410207 Bug Compiler incorrectly reports error message resolved indirectly referenced required files	type logs string level dir supporting normalizer match length normalize
403036 Bug Wrong message content Javadoc	string level supporting rprocname set original project source message fragment
438875 Bug correct project file encodings Unix delimiter	source encoding binding root options level encodings problem point copy
385132 compiler syntax error ARROW COLON COLON shouls	node colon token formatter interval start skip erval parent ations
398490 Don source file build path	type processor compilation files batch rounds pattern mup categorized search
176320 Bug linear progress open type dialog	list folders path tracking copy block factory scope dialog exception
65738 Bug builder Build automatically save	cache manager container classpath listener initialization entry variables raw path
110797 Bug multiple task tags single tasks view complete tag	report type method annotation parameter unused problems missing javadoc reference
456395 Bug compile Java code	variable collection max type jar compiler discriminating secret implicit tmp
366298 publish org eclipse jdt annotation bundle	factory project options file apt registration load processor debug simple
413913 Investigate failures	test failure number points formatter view progress marker start tests
420084 method resolved receiver imported statically	type completion receiver potential start method binding inference binary signature
357110 Bug Problem classes referenced jars folders type resolved	classpath cache raw manager container preferences initialization entry path variables
403705 Investigate failures	test failure number points formatter view progress marker start tests
42243 Bug Incorrect syntax diagnosis source mode	exception init variable flow string label caught exit scratch routine
14597 Bug rearrange source code	source formatter variable modification point copy factory node event binding
385293 compiler compiler accepts normal modifiers type arguments	type source scope node reference field binding declaration element parameter
363293 Bug resource leaks org eclipse jdt compiler tool tests	variable annoproc utilsproc inherited type ables close binding local
429340 Bug content assist Javadoc proposals deprecated tag	type completion node types bindings problems problem expected object names
25377 Bug Error location correct empty array initializer	reference list classpath scratch ide property node auto ident annotations
418599 Bug rid compile warnings official build	reference processor problem compiler logs string command print units total
25890 Bug code assist displays members expressions	binding argument node cache slot variables target type inference signature
410402 Investigate failures	test failure number points formatter view progress marker start tests
153399 Bug javadoc JDT Core warn tag correctly	javadoc problems compiler annotations logs java paths global count files
341296 Bug classpath file read modifications write error	path entry type classpath progress output project library invalid method
11076 Bug Deleted configs remain favorite list	category set element reconcile type project reference file model processor
462147 Bug Documentation compiler options Mars cycle	change entry resolved bound list type reference javadoc missing map
384320 compiler Syntax error mixing type annotations reference expressions	type method invalid annotation field constructor reference error illegal array
78151 Bug Insert single proposals automatically insert prefix	indent source property info scanner formatter edit rewrite event separator
391500 compiler Type annotations Qualified Allocation Expressions dropped	report type method annotation parameter unused missing reference warning overriding
399695 compiler migrate parser syntax methods	source type field declaration compiler string point copy allocation constants
51529 Bug Organize imports confused references Javadoc	type references oized pool unit vector reference single caching imports
403810 tags adjusting	tags javadoc property list comment comments node source min level
402818 formatter Code carrying interfaces halt formatting	formatter width event info store measuring tenance main dir stream
402819 formatter formatting intersection types	formatter width event info store measuring tenance main dir stream
483228 Bug adopt JLS revision	declaration type member element test match annotation file parameter constant
399769 compiler identifier trigger diagnostic	file source compiler java javac processing hash message string num
364450 Dubious path error triggers full rebuild	names path configuration options jar src save reconcile rebuild lookup
147877 Bug source array access isn correct	binding classpath enum project element java problem working copy lookup
485302 Bug Missing warnings Wildcards annotations	annotation type unresolved binding bound annotations bits parameter hierarchy methods
162740 Bug Error website	javadoc comment report process set annotations path options jar tags
343480 Bug compiler Incorrect confusing error message field declaration	javadoc type report reference source element lambda lookup compilation comment
73675 Bug dom AST creation pipeline	processor property source ast range copy marker list generated reconcile
339913 Bug compiler Misleading error message annotations method body	type element node potential binding method reference start previous javadoc
80339 Bug Wrong error message expected writing	logs string level dir supporting normalizer rprocname match length message
144858 Bug compiler resilient duplicate locals	flow string exception binding count field synthetic context logs type
26588 Bug Code Assist variable relevant initialization	completion type element node signature visible declaration binding start types
383968 compiler update checking method modifiers methods	type method declaration field local umented recovered check count block
383970 compiler Detail message Illegal modifier method misses	type method invalid annotation field constructor reference illegal missing array
426998 compiler method java lang java lang String applicable arguments java lang java lang String	doc support
450037 Bug compiler Bogus error message Unhandled exception type Object	string level supporting set options jdk buffer lib
291322 Bug Test errors running JDT Core tests Windows	javac java eclipse error test bug pivot virtual output path
74753 Bug codeassist failing type parameter	type javadoc cache method javac node lookup comment element binding
482309 Bug Organize Imports work accessible binary types	type node types reference method source bindings count unit completion
403457 compiler NPE WildcardBinding signature	type binding match unit file lookup wildcard array unique method
71705 CodeAssist failure simple test	element test failure view unit annotation comment progress level formatter
430108 Bug type wizards Creating pkg type pkg result code error	javadoc types array focus enclosing working project repeated hash comment
336934 compiler NPE Scope getTypeOrPackage	type source binding arguments completion identifier access accessor annotations initializer
412726 API checking anonymous creation corresponds Functional	type declaration field source property list unit anonymous binding constants
149562 Bug Small problem enumerations statements	string type variable source start method statements init constructor explicit
385111 compiler Compiler fails flag undefined annotation type	lang annotation bit util auto exception lect string org java
464977 Bug compiler Deprecated bit	report type annotation lang method acc parameter local exception unused
451677 Bug compiler missing type inference	type binding lookup method arguments result source constant bits target
418919 compiler internal Remove forcing creation annotated bindings	type binding source annotation unit types lookup array node scope
416886 dom ITypeBinding qualifier QualifiedTypeReference wrong	imports unit comment simple explicit ast saved level context kind
17531 Bug GlobalActions File Save fails entering valid file	names string cache comment manager container classpath listener java entry
424075 Bug Compiler regression	logs dir normalizer string match length normalize buffer output xml
181393 Bug DefaultASTVisitor doesn override methods	type methods hashtable object inherited overridden reference parameter binding source
415911 compiler NPE TYPE annotated method missing type	type method binding annotation types unit lookup missing processing file
135328 Bug EJB Creation Wizard fails ejb jar xml invalid	access entry output logs comment saved level pattern root source
391331 compiler Compiler replicate annotations mixed targets	annotation javac test method report failing type element tible utilsproc
24747 Bug incorrect compile error message	problems type file compiler count files logs error errors global
398520 Bug bindings annotations Annotations binary constructor match source code	type method annotation binding types unit lookup search processing progress
124099 Bug compiler incorrect merge flowInfo UnconditionalFlowInfo addInitializationsFrom flow info	field init cache block inits exceptions context flow binding pre
381121 grammar Arrays allowed reference expressions	local mask extended element method check supporting level proposal ictly
399567 error message reference compiler	problems source compiler javadoc tag element error options file paths
480462 Bug add external annotations Guava libraries	listener change project resolved unit classpath entry status java delta
483534 Bug search Open Method error parameterized methods	type method binding search pattern variable progress lookup receiver location
43212 Bug variable recognized code completion	token extended types container exception bidden references lib values core
427223 Bug compiler NPE resolution method arg type	type local method arguments check block empty source declaration statement
429279 Java search support degrades indexing performance	search path element document project system relative result mup type
471270 Bug Enrich IllegalArgumentsExceptions actual arguments org eclipse jdt internal core util Util	type method binding expression target formatter position lookup argument slot
490724 Bug compiler Compilation source classfile aborts reference member type parameterized type	type method file binding missing lookup declaration unique unit enum
126180 Bug compiler NPE reporting invalid enclosing type	type potential arguments variable receiver binding context target method lookup
3313 Severe Performance Java Model redundancies GFKTUN	test scenario format measuring string letions mup project measures java
399600 ASTConverter retrieveEndOfRightParenthesisPosition fails cases	string test type method vector javac block init pool unit
419057 ITypeBinding getModifiers misses implicit member	binding type imports bindings pair ast copy annotation context unit
103672 Bug compiler problem VARARGS ARGUMENT explains solutions	type method local inference variable umented lookup check expression source
193784 Bug Proprietary licenses	javadoc comment report process original string annotations options buffer comments
456960 Bug Broken classfile generated incorrect annotation usage	type method annotation invalid field constructor reference illegal array javadoc
335118 Bug avoid code pattern unnecessarily signal potential JDT Core code	flow ide auto ident type participant search undo options tag
424226 method method reference	type cache method field binding synthetic methods receiver potential pool
384317 compiler smarts needed Scanner jumpOver	ptr comment length start node completion count sibling tags leading
179529 Bug Eclipse takes lot time big workspace	formatter token extended scenario types format start string mup project
83297 Bug Annotation bindings don provide declared elements methods	binding element type node visible completion unit problem object copy
487781 Bug bogus error editor referenced type type annotations type parameter	type local processor method check source block statement empty element
405889 compiler codegen Resilience NPE needed Scope getJavaLangInvokeMethodHandlesLookup	type arguments binding init context source variable lookup inference receiver
340365 Bug Problems APIs TryStatementWithResources DisjunctiveType	element src project monitor requestor path unit problem compilation root
168331 Bug compiler AbstractMethodError method	tag handling policy factory problem options doc compiler support ging
30099 Bug NamingConvention suggestArgumentNames guess returned	element token processing binding type extended types env reference anno
30102 Bug NamingConvention Tests fail	logs transitions processing file row table compared mark dir start
399768 DOM AST Type Annotation Tests	test marker ast buffer node label source root working copy
381345 care Java major version	acc constant count compiler bad err file method problems tag
381358 Compiler gracefully reject JSR constructs source levels	source reference element compliance dimensions directory test annotation javadoc local
403881 formatter Receiver parameter halts formatting	formatter indent width event info store measuring tenance main aries
36271 Bug CodeAssist treat array clone visible	token extended types location container exception bidden auto references lib
416181 compiler Inalid assignment rejected compiler	type method enclosing bypass hides parameterized invocation parameter mismatch ective
41395 Bug StackOverflowError pasting code	type binding max ast references values pending substitute recursive declaring
71113 improve DOM AST specs bindings JLS constructs	ast node test optional modification compilation property list working copy
148944 Bug render resource folders JARs	paths project folder folders classpath projects source strings set locations
165346 Bug compiler org eclipse jdt internal compiler ast OperatorExpression nullStatus FlowInfo conservative	flow exception context binding assign type field count contexts check
230885 Bug content assist NPE ParameterGuesser createVariable	copy annotation marker supporting level type array options set list
334315 Bug compiler Problem types missing superclass superinterfaces Object missing types	type field methods bound declaration binding source exception allocation unit
424444 VerifyError constructor reference primitive array	modification env node processing event annotation resolver mirror level binding
96765 Bug Code completion work enum constants	level access unit search java working copy supporting container exception
412155 compiler Calling deprecated method separate lambda ClassCastException terminates AST generation	method type acc fixed constant target potential field tag receiver
419331 compiler Weird error reference type annotations type parameter declarations	type source local annotation element variable method umented lookup binding
425493 Bug Compiler regression	logs dir normalizer string match length normalize buffer output xml
427538 Bug infrastructure Enable CompletionTests ResolveTests rtstubs jar	list logs path factory dir normalizer dialog string project button
426515 dom ast Bindings reconciler missing type annotations	binding type element parameter types problem declaring member working copy
388634 Test failure Compliance compliance	javac eclipse java compliance test output type bug root error
420413 dom ast AST newArrayType Type create dimension array	imports node property modification simple type list context kind existing
405051 JavaModel refreshExternalArchives happen search primed	paths array search java path rule projects project enclosing fragment
416313 compiler Typeids unique plausibly broken cherry picking	type method binding lookup problem types unit missing options enum
39499 Bug keyword completion work anonymous classes	completion start signature declaration names type receiver additional flags required
41554 Bug Assertion failure search	type tree failure formatter lookup scroll context inference test icon
426590 compiler Compiler error tenary	tags javadoc comment comments ables close report missing invalid visibility
407131 dom ast ASTRewrite support ReferenceExpression nodes family	node property copy edit event bindings source ast comment range
421473 compiler Delayed assignment declaring scope arguments creates race condition	type variable local binding collection source lookup check secret synthetic
417388 TypeBinding TypeReference parameter type annotations	type binding annotation potential parameters receiver reference source method references
420458 dom ast JLS ASTParser multi dimensional array reference Javadoc	format node property list ast options source marker compilation modification
420456 AIOOB analysis code	variable set type declarations explicit reference routine scope statement options
416379 parser type annotations type methods	type method declaration field lookup progress search source scope pending
420482 ExecutableTypeImpl getParameterTypes include type annotation type parameter	type completion binding parameter start signature declaration names types receiver
401035 tests started failing	tag start position source stack javadoc javac doc type token
411273 compiler Bogus error unhandled exceptions unchecked exceptions thrown method reference	exceptions type flow context binding exception method cache constructor node
421536 compiler Verify error small program preserved unused variables	report type method annotation parameter unused missing warning overriding reference
426676 compiler Wrong method type inferred lambda expression	type method inference variable invocation receiver potential lookup enclosing expression
414384 type annotation abbreviated marked type	marker type annotation ast buffer node tible binding label source
388800 adjust tests JRE	libs virtual problem processing output values batch evaluation file variable
404169 Bug deprecation warnings test projects junit framework	result search values count format war mup eams str number
475865 JDT deletes code	variable type reconcile generated project vars unit built folder deps
420582 compiler Compiler creation array creation unbounded wildcard type arguments	node length stack ast start position error bracket ptr source
427748 Bug compiler convert type	unit level supporting reference type binding compilation declaration jdk string
418528 internal Tests pass suite fail suite suites	directory compliance cursor start project token unit tests java compilation
416480 Bug Error bytecode generated ECJ compiler leads IncompatibleClassChangeError	variable logs discriminating dir normalizer string routine normalize statement buffer
383714 compiler Compile fails reject constructs modes	problems compiler paths count global annotations type files discriminating javadoc
415470 compiler Type annotations declaration vanishing	type pending scope local method block field recovered check source
27370 Bug code assist working	annotation cache java copy cursor start type token unit compilation
421620 compiler wrong compile error TYPE annotation exception	javac problem java processor eclipse source reference output error test
421628 dom ast api document rules ITypeBinding equality	test source library root classpath level project list entry java
86779 Bug AST resolveWellKnownType support primitive type wrappers	type unit binding comp ast project comment saved reference cache
209661 Bug ILocalVariable method parameter misses annotations	property types source annotations root variable list param range unit
424718 compiler API compatibility AST TypeReference	type potential receiver binding method variable reference inference parameters contexts
484114 Bug content assist Flow sensitive typing doesn work autocompletion condition	init type pre flow expression synthetic field binding exception argument
177962 Bug timestamp working copy	cache manager container listener classpath entry variables path raw initialization
445231 Bug compiler IllegalAccessError running Eclipse compiled	project requestor compiler annoproc src testing environment inherited root path
466730 Bug Java single method generics ambiguous inheritance	node fine pattern visitor declaration set matching ast grain locator
145202 Bug positive reference analyzer negated	imports zip logs reference ast scratch annotation dir simple context
415541 compiler Type annotations body initializer dropped	type field local declaration recovered pending count enum source constructor
104245 Bug AST newCompilationUnit javadoc error	report type method parameter annotation unused missing source javadoc tag
30516 Bug typo javadoc IPackageFragmentRoot isArchive	paths array path project enclosing type focus source copy annotation
301894 Bug OutOfMemory error building large project annotations	type entry project progress path method library invalid output classpath
433989 Bug Nested reference incorrectly marked compile error	type javadoc potential receiver instance method scope comment variable binding
398158 Receiver qualifier simple qualified	type declaration variable node annotation comment source property receiver element
29516 Bug SearchEngine regressions	project search system indexing unit requested compilation working copy document
480075 Bug Nested Terniary Lambda derives unknown	type binding potential method receiver variable instance scope variables argument
386901 Bug Eclipse pass annotated classes annotation processor	unit type processing sum env visitor string binding reference root
249692 Bug ImportRewriteAnalyzer honor formatter setting	imports formatter original modifier declaration container explicit simple names result
29536 Bug Check IResource getLocation	model element entry array change resolved java patterns paths root
73573 Bug CodeAssist ArrayIndexOutOfBoundsException genric type completion	cache completion node names container exception bidden references lib values
148328 Bug javadoc nested unescaped XML tags	javadoc compiler problems list annotations classpath paths property global count
396139 define JRE build targeting BETA JAVA	bounds type libs variable virtual processing bound output java problem
484220 Bug dom ast compiler Invalid AST structure	wrap tag source token start comment position ast options format
417659 dom ast test failures ast structure debug tracing	wrap options source comment format ast start binding element level
383884 compiler Compiler tolerates illegal dimension annotation literal expressions	scope type binding node warning source count string method literals
424845 Wrong resolution type compliance settings	source level formatter point copy options supporting paths ast project
422800 compiler Missing code implementation compiler	report type method annotation parameter unused missing warning overriding reference
428985 Bug type inference find nullness annotated type	type binding location element bits array variable unchecked constant ast
79809 Bug dom javadoc support type parameter Javadoc tags	report type method annotation parameter unused javadoc missing reference warning
25539 Unexpected inaccurate search	accessed fields lookup nodes set simple participant search doc comment
406469 dom ast ASTRewrite support PackageQualifiedType	property ast element occurred unit compilation insertion creation policy list
497603 Bug compiler type inference bug	type receiver variable binding potential lookup method arguments source constant
318401 Bug FUP Clarify eclipse compiler behavior imports shadowing	imports type test root nest overing single context kind existing
417759 NPE analysis	variable binding init synthetic field exception argument set bits routine
69598 Auto Completion loop	flow exception count variable contexts binding context label ast project
396258 adopt syntax annotations qualified type names NullTypeAnnotationTest	cache info count snippet unit counts occurrence project scratch reference
430069 Test failures JRE	test libs failure number points formatter progress field text tests
481276 Bug Error markers removed fixing annotations	factory source type jar classpath markers strings simple compile folder
441338 Bug combine type annotations substitution parameterized type	type binding bounds method variable element unchecked source bound auto
