33806 Bug Code assist failure assignment loop hides previous variables	 type container cache classpath variable set expression save external record
23573 Bug AST clone source locations	 type annotation build locations project structural element location classpath java
405038 Bug formatter infix expression formatting broken spaces binary	 test indent wrap set declaration comment type dir formatter string
383046 compiler Error reported lambda expression subsequent parse error	 type consume expression assist test declaration element lambda recovery block
152135 Bug breakpoints Hovering conditional breakpoint condition	 type code field expression scope mark info optimized set variable
178760 Bug Copy Paste mechanism work	 test type compiler file set operation processor javac tests job
405069 compiler codegen Generate code method references	 reference type field generate access test ward expression binding arity
234074 Bug Compliance test fails launched JRE Dcompliance	 test file path compiler processor output print string javac set
410207 Bug Compiler incorrectly reports error message resolved indirectly referenced required files	 test type classpath output project expected check missing compiler string
403036 Bug Wrong message content Javadoc	 test comment tag javadoc wksp output source html java diagnostic
438875 Bug correct project file encodings Unix delimiter	 test type source set comment declaration expression verify binding compiler
385132 compiler syntax error ARROW COLON COLON shouls	 type expression consume array test declaration create set reference handle
398490 Don source file build path	 test type build project source file generated tests declaration compilation
176320 Bug linear progress open type dialog	 test project add java element folder remove path external create
65738 Bug builder Build automatically save	 test container classpath cache type set add save variable path
110797 Bug multiple task tags single tasks view complete tag	 log classpath test path java file set source tag problem
456395 Bug compile Java code	 type file expression output folder check test processor compiler arity
366298 publish org eclipse jdt annotation bundle	 test project java output options annotation tests create expected path
413913 Investigate failures	 test create add failure dir set source string error suite
420084 method resolved receiver imported statically	 type completion method set test lang find field enclosing unresolved
357110 Bug Problem classes referenced jars folders type resolved	 classpath test project container output external type cache path set
403705 Investigate failures	 test create add failure dir set source string error suite
42243 Bug Incorrect syntax diagnosis source mode	 type start accept exception enter exit scope reference routine code
14597 Bug rearrange source code	 set type declaration expression source statement method node create compilation
385293 compiler compiler accepts normal modifiers type arguments	 type expression consume set method annotation declaration test retrieve source
363293 Bug resource leaks org eclipse jdt compiler tool tests	 test type check system method annotations flow lone scope expression
429340 Bug content assist Javadoc proposals deprecated tag	 type completion find java set relevance variable types method element
25377 Bug Error location correct empty array initializer	 test classpath project java type root resource element create cycle
418599 Bug rid compile warnings official build	 test source problem compiler build output expected progress project file
25890 Bug code assist displays members expressions	 type test expression set info method create unit code copy
410402 Investigate failures	 test create add failure dir set source string error suite
153399 Bug javadoc JDT Core warn tag correctly	 test log file path comment problems source output classpath set
341296 Bug classpath file read modifications write error	 path file classpath container test add save string type cache
11076 Bug Deleted configs remain favorite list	 file project reconcile delta path type set element add source
462147 Bug Documentation compiler options Mars cycle	 type classpath test project java build set entries element cycle
384320 compiler Syntax error mixing type annotations reference expressions	 test type expression set code source result kosher parameter exception
78151 Bug Insert single proposals automatically insert prefix	 type test indent rewrite node insert declaration comment expression empty
391500 compiler Type annotations Qualified Allocation Expressions dropped	 type annotation expression source element set method check inference string
399695 compiler migrate parser syntax methods	 type set method test source constructor accept parse start unit
51529 Bug Organize imports confused references Javadoc	 imports type test javadoc reference demand comment declaration add string
403810 tags adjusting	 tags completion property test javadoc method error field options constructor
402818 formatter Code carrying interfaces halt formatting	 test indent dir comment create string formatter set indentation file
402819 formatter formatting intersection types	 test indent dir comment create string formatter set indentation file
483228 Bug adopt JLS revision	 test type declaration expression doc method statement annotation member remote
399769 compiler identifier trigger diagnostic	 test file compiler compilation diagnostic num type resource processing stream
364450 Dubious path error triggers full rebuild	 test java project remove source add file type classpath missing
147877 Bug source array access isn correct	 test type classpath method project source cycle create add invalid
485302 Bug Missing warnings Wildcards annotations	 type annotation method scope code binding check types recursive parameterized
162740 Bug Error website	 test set type file member javadoc reference qualified single lambda
343480 Bug compiler Incorrect confusing error message field declaration	 type method annotation reference field expression error invalid test array
73675 Bug dom AST creation pipeline	 test type annotation binding declaration decl source binary processor working
339913 Bug compiler Misleading error message annotations method body	 consume type expression assist element declaration set annotation recovery method
80339 Bug Wrong error message expected writing	 test compiler expected output string extra manifest expression problem classpath
144858 Bug compiler resilient duplicate locals	 test type string method scope tracking variable local expected check
26588 Bug Code Assist variable relevant initialization	 type set consume element assist declaration types completion accept method
383968 compiler update checking method modifiers methods	 type method enclosing annotation annotations update constructor scope source print
383970 compiler Detail message Illegal modifier method misses	 type method annotation reference field invalid expression error variable illegal
426998 compiler method java lang java lang String applicable arguments java lang java lang String	 test regression options compiler lambda method constructor type javadoc field
450037 Bug compiler Bogus error message Unhandled exception type Object	 test type lambda boxing hash loop options diagnostic pot compiler
291322 Bug Test errors running JDT Core tests Windows	 test compiler file dir tests source output javac processor string
74753 Bug codeassist failing type parameter	 type test field element info inference unit create method expression
482309 Bug Organize Imports work accessible binary types	 type imports test find method completion types annotation source create
403457 compiler NPE WildcardBinding signature	 type consume binding annotation method declaration match parameterized pattern collect
71705 CodeAssist failure simple test	 test create dir source verify suite string failure variable set
430108 Bug type wizards Creating pkg type pkg result code error	 type test source resource path types java find folder element
336934 compiler NPE Scope getTypeOrPackage	 type inference set code access constructor scope start print qualified
412726 API checking anonymous creation corresponds Functional	 type set constructor scope binding unit method hierarchy level enclosing
149562 Bug Small problem enumerations statements	 type method element problem field arguments code declaration scope source
385111 compiler Compiler fails flag undefined annotation type	 type method annotation field reference error expression invalid illegal test
464977 Bug compiler Deprecated bit	 type deprecated annotations string tag binding annotation invocation compatible options
451677 Bug compiler missing type inference	 type expression inference method set check argument binding code annotations
418919 compiler internal Remove forcing creation annotated bindings	 type set method expression binding annotation source retrieve declaration array
416886 dom ITypeBinding qualifier QualifiedTypeReference wrong	 type test annotation set binding verify source imports annotations binary
17531 Bug GlobalActions File Save fails entering valid file	 container classpath cache type save external variable test existing file
424075 Bug Compiler regression	 test compiler expected output manifest method classpath string cascaded work
181393 Bug DefaultASTVisitor doesn override methods	 method test type inherited check methods annotation clash rules statements
415911 compiler NPE TYPE annotated method missing type	 type annotation method annotations create types bound synthetic annotated code
135328 Bug EJB Creation Wizard fails ejb jar xml invalid	 test classpath project source entry output jar library add file
391331 compiler Compiler replicate annotations mixed targets	 test annotation type check annotations repeatable target bits compiler element
24747 Bug incorrect compile error message	 test log set path problem type problems output classpath compiler
398520 Bug bindings annotations Annotations binary constructor match source code	 type method annotation create annotations element types match reference set
124099 Bug compiler incorrect merge flowInfo UnconditionalFlowInfo addInitializationsFrom flow info	 exception record field info code inits mark flow scope initialization
381121 grammar Arrays allowed reference expressions	 test type context invocation required completion set lambda ictly print
399567 error message reference compiler	 log type test consume error problem annotation path file set
480462 Bug add external annotations Guava libraries	 test classpath project external path source java type entry element
483534 Bug search Open Method error parameterized methods	 type method enclosing reference lang search scope match pattern declaration
43212 Bug variable recognized code completion	 completion type test method field unresolved find token variable set
427223 Bug compiler NPE resolution method arg type	 type test inference expression annotation annotations check set argument print
429279 Java search support degrades indexing performance	 search test type match create big method declarations document element
471270 Bug Enrich IllegalArgumentsExceptions actual arguments org eclipse jdt internal core util Util	 type set expression dir method code exception inference source annotation
490724 Bug compiler Compilation source classfile aborts reference member type parameterized type	 type method create test lang set annotation binding binary field
126180 Bug compiler NPE reporting invalid enclosing type	 type test expression inference compatible constructor set reference check argument
3313 Severe Performance Java Model redundancies GFKTUN	 test type search project buffer element file complete big count
399600 ASTConverter retrieveEndOfRightParenthesisPosition fails cases	 test type existing code report scope file reference tests method
419057 ITypeBinding getModifiers misses implicit member	 type binding resolve annotation method member imports declared declaring declaration
103672 Bug compiler problem VARARGS ARGUMENT explains solutions	 type method check inference argument lang expression variable enclosing invocation
193784 Bug Proprietary licenses	 javadoc method bugs reference field test declaration string lines type
456960 Bug Broken classfile generated incorrect annotation usage	 test log type source file path field compiler set problems
335118 Bug avoid code pattern unnecessarily signal potential JDT Core code	 set java classpath variable element test add search code resource
424226 method method reference	 type method lang reference constructor enclosing field string accept scope
384317 compiler smarts needed Scanner jumpOver	 consume type comment declaration parse comments statement syntax reference parser
179529 Bug Eclipse takes lot time big workspace	 test type set project file path token java big find
83297 Bug Annotation bindings don provide declared elements methods	 type test element binding method annotation java visible elements source
487781 Bug bogus error editor referenced type type annotations type parameter	 type test annotation annotations bound binding inference method print recursive
405889 compiler codegen Resilience NPE needed Scope getJavaLangInvokeMethodHandlesLookup	 type scope access expression inference generate field set context method
340365 Bug Problems APIs TryStatementWithResources DisjunctiveType	 test type method annotation project source add buffer classpath change
168331 Bug compiler AbstractMethodError method	 test problem type temp error method result policy handling message
30099 Bug NamingConvention suggestArgumentNames guess returned	 type test token element set method file string zip node
30102 Bug NamingConvention Tests fail	 test expected source check output compiler print method file string
399768 DOM AST Type Annotation Tests	 test binding annotation type marker node binary annotations source path
381345 care Java major version	 file log path print files count error problem source problems
381358 Compiler gracefully reject JSR constructs source levels	 type annotation test consume compliance validate source annotations check element
403881 formatter Receiver parameter halts formatting	 test indent create set comment dir string formatter indentation file
36271 Bug CodeAssist treat array clone visible	 type method lang enclosing token visible set completion types scope
416181 compiler Inalid assignment rejected compiler	 test type field valid binding assignment source generate write flow
41395 Bug StackOverflowError pasting code	 type test bound method initializer binding bounds annotation inference parameterized
71113 improve DOM AST specs bindings JLS constructs	 type set expression declaration binding marker property bindings statement node
148944 Bug render resource folders JARs	 classpath set path build add type project remove java external
165346 Bug compiler org eclipse jdt internal compiler ast OperatorExpression nullStatus FlowInfo conservative	 type record exception context check expression flow expected field code
230885 Bug content assist NPE ParameterGuesser createVariable	 test type completion element binding annotation source memento method code
334315 Bug compiler Problem types missing superclass superinterfaces Object missing types	 type method types check hierarchy inherited bound set missing binding
424444 VerifyError constructor reference primitive array	 type declaration annotation expression method array element binding test member
96765 Bug Code completion work enum constants	 test completion set find search container type verify create lines
412155 compiler Calling deprecated method separate lambda ClassCastException terminates AST generation	 type method expression set declaration variable field tracking check constructor
419331 compiler Weird error reference type annotations type parameter declarations	 type consume method annotation annotations declaration enum set field header
425493 Bug Compiler regression	 test compiler expected output manifest method classpath string cascaded work
427538 Bug infrastructure Enable CompletionTests ResolveTests rtstubs jar	 test path jar list expected compiler add set output model
426515 dom ast Bindings reconciler missing type annotations	 test type method annotation member binding source binary classpath add
388634 Test failure Compliance compliance	 test compiler compliance processor file output type javac requestor expected
420413 dom ast AST newArrayType Type create dimension array	 test type set declaration annotation expression statement imports comment method
405051 JavaModel refreshExternalArchives happen search primed	 test jar path element java document search external elements memento
416313 compiler Typeids unique plausibly broken cherry picking	 type annotation annotations create method types set bound binding code
39499 Bug keyword completion work anonymous classes	 test completion type method set field find unresolved variable accept
41554 Bug Assertion failure search	 test type set dir assertion inference failure string expression log
426590 compiler Compiler error tenary	 test error tags method constructor missing deprecated field compiler support
407131 dom ast ASTRewrite support ReferenceExpression nodes family	 node type copy move binding resolve set list property range
421473 compiler Delayed assignment declaring scope arguments creates race condition	 type expression field inference reference invocation scope generate binding set
417388 TypeBinding TypeReference parameter type annotations	 type annotation inference bound check set annotations resolve binding scope
420458 dom ast JLS ASTParser multi dimensional array reference Javadoc	 type set declaration expression property method child element string bindings
420456 AIOOB analysis code	 type expression test statement code binding check scope analyse save
416379 parser type annotations type methods	 test type method element search declaration constructor source parse create
420482 ExecutableTypeImpl getParameterTypes include type annotation type parameter	 type set method parameter test binary annotation signature annotations memento
401035 tests started failing	 test type create parse token big find count tag reconcile
411273 compiler Bogus error unhandled exceptions unchecked exceptions thrown method reference	 type exception record method exceptions field check context expression options
421536 compiler Verify error small program preserved unused variables	 test variable java string classpath type set output options dir
426676 compiler Wrong method type inferred lambda expression	 type inference expression set variable argument check method invocation add
414384 type annotation abbreviated marked type	 type annotation binding marker node test bindings element repeatable start
388800 adjust tests JRE	 path file source initializer problem declaration visit evaluation jar string
404169 Bug deprecation warnings test projects junit framework	 test initializer tests search java source container change deprecated perf
475865 JDT deletes code	 file project test delete source reconcile code variable snippet root
420582 compiler Compiler creation array creation unbounded wildcard type arguments	 type consume expression set declaration method empty array annotation header
427748 Bug compiler convert type	 test type compilation element source expression method unresolved reference field
418528 internal Tests pass suite fail suite suites	 test compliance tests context suite build create zip enclosing visible
416480 Bug Error bytecode generated ECJ compiler leads IncompatibleClassChangeError	 test file output compiler expected string source manifest type detector
383714 compiler Compile fails reject constructs modes	 type log file test output set files path expression problems
415470 compiler Type annotations declaration vanishing	 type expression annotation declaration set retrieve annotations source start scope
27370 Bug code assist working	 type element test create working find info source buffer annotation
421620 compiler wrong compile error TYPE annotation exception	 test compiler source type file expected problem output unit javac
421628 dom ast api document rules ITypeBinding equality	 type declaration create expression annotation bindings mirror array binding ast
86779 Bug AST resolveWellKnownType support primitive type wrappers	 type binding declared source verify set file test declaration processor
209661 Bug ILocalVariable method parameter misses annotations	 type test method source declaration property member resolve element field
424718 compiler API compatibility AST TypeReference	 type expression annotation code array reference receiver set inference resolve
484114 Bug content assist Flow sensitive typing doesn work autocompletion condition	 expression field test scope code type mark info optimized status
177962 Bug timestamp working copy	 test type add external classpath container cache element working remove
445231 Bug compiler IllegalAccessError running Eclipse compiled	 test expecting annotation problems tests build compiler type java project
466730 Bug Java single method generics ambiguous inheritance	 type test consume method expression reference annotation declaration additional boxing
145202 Bug positive reference analyzer negated	 type test annotation set expected context binding imports output compiler
415541 compiler Type annotations body initializer dropped	 type field recovered pending update constructor declaration scope method enclosing
104245 Bug AST newCompilationUnit javadoc error	 type token parse string tag create reference code position annotation
30516 Bug typo javadoc IPackageFragmentRoot isArchive	 test path type element jar source project set file enclosing
301894 Bug OutOfMemory error building large project annotations	 test file project missing path external tests annotation dir annotations
433989 Bug Nested reference incorrectly marked compile error	 test type tracking variable method local scope lambda set check
398158 Receiver qualifier simple qualified	 type test consume expression set declaration node retrieve completion check
29516 Bug SearchEngine regressions	 test search type scope declaration method pattern constructor document ignore
480075 Bug Nested Terniary Lambda derives unknown	 test type lambda set variable tracking field check method reference
386901 Bug Eclipse pass annotated classes annotation processor	 test type processing annotated unit examine elements reference file gen
249692 Bug ImportRewriteAnalyzer honor formatter setting	 declaration imports rewrite comment test formatter lines handle type brace
29536 Bug Check IResource getLocation	 project classpath set path delta java element test file entry
73573 Bug CodeAssist ArrayIndexOutOfBoundsException genric type completion	 completion type test method field unresolved element create find basic
148328 Bug javadoc nested unescaped XML tags	 test classpath log source set extra file path tag javadoc
396139 define JRE build targeting BETA JAVA	 test type bound path variable initializer project problem source external
484220 Bug dom ast compiler Invalid AST structure	 token type source parse test wrap declaration set tag comment
417659 dom ast test failures ast structure debug tracing	 type declaration expression source wrap verify prepare test ast comment
383884 compiler Compiler tolerates illegal dimension annotation literal expressions	 type test set expression declaration retrieve array convert source literal
424845 Wrong resolution type compliance settings	 set test source validate type classpath problem java regression compilation
422800 compiler Missing code implementation compiler	 type java set classpath variable element missing property string entry
428985 Bug type inference find nullness annotated type	 type check binding bound argument annotation method code tag bounds
79809 Bug dom javadoc support type parameter Javadoc tags	 tags test source method string verify error type javadoc field
25539 Unexpected inaccurate search	 set match type element declaration matching field binding level reference
406469 dom ast ASTRewrite support PackageQualifiedType	 test declaration move decl type rewriting target list insert element
497603 Bug compiler type inference bug	 type inference method check bound expression set reference argument binding
318401 Bug FUP Clarify eclipse compiler behavior imports shadowing	 test type imports string add demand comment annotation source compiler
417759 NPE analysis	 test type annotation code save expression check flow synthetic lone
69598 Auto Completion loop	 test context buffer record type completion flow selection element reference
396258 adopt syntax annotations qualified type names NullTypeAnnotationTest	 test type method consume expression statement syntax info create set
430069 Test failures JRE	 test add failure dir set source create error string tree
481276 Bug Error markers removed fixing annotations	 test classpath type project source external add file container create
441338 Bug combine type annotations substitution parameterized type	 type method bound lang types enclosing annotation argument find bounds
