182277 Plug Dependencies View System packages distinguished framework packages	add dependencies bundle find packages classpath search dictionary plugin java
173072 Wrong plugin editor opened clicking plugin	test create editor bundle element file form body save hyperlink
177177 Extension points dependencies	search set assist extension attribute content schema outline proposal ext
119843 Exporting plug leaves file javaCompiler args	plugin launch set export source baseline test delta file workspace
206887 Bug Building workspace IES target large number plugins takes longer	target test bundle plugins read location workspace init extract plugin
331811 Bug Polish Scan Feature	feature model method test plugin type pattern multi item base
230447 Invalid warning bundle classpath	bundle source missing validate export header target project file error
226349 Eclipse logs seemingly useless install bundle error bundle	target export missing bundle build plugin error header components invalid
151609 Remove deprecations plugin xml	extension file api cache baseline model remove delta manifest report
251970 Bug tooling OSGi Declarative Services template generates invalid MANIFEST	template wizard create label service splash model manifest sample field
229441 invalid flagging internal extension points	extension set content bundle create attribute assist item service action
118850 Bug PDE Launcher program arguments command arguments	launch program configuration model plugin arguments argument form problem config
322637 Validation dialog closes properly	create version plugin feature validation image test entry duplicate dialog
166984 Eclipse Application launch config fails SWT fragment workspace	product workspace plugin config application launch configuration initialize create manifests
174168 Wrong dialog enter version number exported	test target bundle plugin filter version feature dialog item location
321624 Pgm Arguments duplicated launching product editor	launch form config configuration plugin product model args arguments create
140381 Bug Convert produces warnings build properties existing	source file plugin build project entry validate src test set
149604 Amnesia opening manifest JARd plug	bundle set source plugin model manifest create locations extensions schema
183405 Manifest Editors Required Plug ins title missing Dependencies	plugin action error message target title label file wizard add
277611 target Target Platform brings plugins previous installations	target bundle test button model plugins plugin container source feature
154739 PDE editor tab tooltip fully qualified opened plugin deps view	plugin action title message error label target group file dialog
322672 Bug PDE API create build model	create plugin build file model update set action form context
96385 Bug inconsisent casing	test type product validate manifest local anonymous file project illegal
96384 Bug Runtime LIbrary classpath	library plugin classpath entries entry add create source project path
263306 Bug Installed metadata group longer spans preference	target create source profile tracing file button export unit include
195729 Bug Provide plug ins CVS plug ins tab	model plugin external add models workspace set bundle delta target
209046 Bug context ids templates	create extension template service model parent work option application cycle
155796 Bug Patch jface text deprecation	text create feature patch site set version install form configuration
224409 ability mark extension points internal	set extension form create attribute content point assist bundle service
94366 Bug Feature appears feature selection dialog	feature plugin handle button model create selection set features content
209056 Bug config ini generated eclipse launch configuration work target	configuration launch plugin bundle config args product location feature features
134311 validation Java project source output folders Plug Project Wizard	set bundle source entry library build output create model classpath
116919 Bug Plug Manifest Editor loses dependency addition	plugin action error message title label target editor file resolution
224447 Bug change internal manifest file picked	change file extension manifest header model create bundle delta plugin
180420 Plug wizard defaults biased plug development	model plugin models bundle configuration ernationalize plugins folder perform locale
179401 Shells created launcher buttons wrong parents	test target bundle workspace resolution update configuration file initialize missing
221390 Bug Hide selection user	action filter text open set create selection application product model
113870 Bug PDE editor improperly process extension points defined fragments	set extension model search form content splash assist element attribute
274646 Bug Progress reporting API comparison hits	set api search container type bundle find include filter resource
229584 Compute dependencies feature broken	plugin action error title message target label file editor resolution
158945 PDE handle space required bundle version	target bundle set profile bundles source location create build version
154853 Missing border Extensions tab	plugin action target title error message label file wizard resolution
430305 Bug Remove unsupported bytecodes preference Luna	resolution target api status perform workspace preference annotation tag build
118008 Bug field disabled	action option initialize model wizard bundles tree set site title
185597 Errors creating school plug ins	model plugin external models add workspace ernationalize delta version bundle
206081 Source Locations included directories target platform	test target bundle set feature source missing stream arguments version
139526 Extra Dependency	field dependency classpath add plugin test find form entries dependencies
213255 Bug Extension point schemas valid Schemas	extension schema element plugin point attribute filter assist source model
272641 Bug Externalize Strings MANIFEST suffix header	change properties manifest strings file externalize participants input create selected
272654 Manifest Editors Select text creating attribute element	attribute element set manifest create form selection model error update
231688 Bug filter error MANIFEST	plugin target error action message title manifest label file project
481559 Bug Remove redundant Javadoc statements org eclipse pde tests	test remove add method compatibility problem type exported tests instantiate
215314 manifest editor content assist additional info wrong status text	plugin action error message title label target file wizard resolution
213268 open plug artifact filter stringent	action log filter open profile model target resolution create set
461083 Bug target Target definition editor prematurely editing Software Site	target feature category site changed form selection model handle create
354586 Bug API Errors Warnings severity fishy	api build problem compatibility validate set report severities version source
125221 doc missing context	set create api component tag control type declaration preview add
208164 Regression Extension search longer highlighted plugin editor	plugin action label error message title target file wizard resolution
159020 Included Features don Feature Editor Outline	set feature create form action content features editor target handle
266548 target Move target button targets moved top	target extension handle filter remove create add button tree set
198961 Feature dependency calculations include	plugin target action error message title label file resolution add
198965 Feature Editor find feature dependencies correctly	plugin action title error message label file target editor feature
95542 Bug PDE attempt add external folder classpath	add build plugin project model entry source entries validate classpath
131394 Bug javacVerbose	test product type local anonymous illegal bundle open method gen
184646 Launchers Add Required Plug ins acts weird	set model plugin add feature remove external models workspace delta
97605 Dialog cut High Contrast	win action create editor register add icon contribute tab manager
184644 Feature Editor Sorting incorrect	plugin action title error message label target file editor resolution
186701 Target Environment Amnesia	target set bundle form properties test dictionary model environment add
172374 Bug Launch Eclipse Application clears target workspace determines	plugin launch product config plugins configuration validate workspace problem attributes
256343 Bug update API tooling tags avoid errors	api tag check element problem version type action session compatibility
163161 Bug PDE Extension Wizard creates bad plugin xml file	plugin action label error message title file target extension wizard
185696 Bug Manifest Editors Automated Management Dependencies Title disappears	plugin action error message title label target add wizard file
221547 Bug Profiles bind installs change	change api set element configuration severities version perform compatibility remove
130411 Bug Copyright statements missing java files	set build validate create add element entry source project extra
113004 Bug Plug dependencies element disappears working	source plugin project set build working search tree create current
149900 PDE Locks adding ton required plugins sweet time	model plugin workspace plugins target button handle feature launch external
108954 Error project creation manifest file created classpath	plugin action error message title label target file project set
248216 Bug tooling buttons properties	action api session property wizard build properties set update add
229791 Bug save version info launch configurations needed	info set configuration product launch create plugin model feature build
183708 Plug Dependencies View opening view manifest editor	plugin action error title message label target file resolution wizard
228765 existing config ini product editor	product launch config configuration plugin model create application set bundle
163258 Bundle Localization Manifest Header honored plugin xml editor	plugin file bundle model extension remove change fragment delta packages
145854 Create template OSGi service	template wizard label splash sample model field service action generate
155070 Exporting feature saving Ant script generates functional script	build export target missing bundle set error header exception source
171462 clean templates	template branding generate description clean set resource directory add location
109003 Bug editing plugin xml located subfolder plugin project edits MANIFEST root	file model plugin bundle element set packages project manifest api
213457 erroneous extension validation content assist	content proposal assist text extension attribute action source completion plugin
221655 plug ins view useless content description	model content action external set plugin add workspace manager handle
319965 Bug Feature Project Referenced Plug ins Fragments multiselection functionality	model plugin set feature add workspace remove external models bundle
199129 Bundle Localization header Fragments externalized	validate bundle header packages model element change version plugin check
168417 Generated Ant Script export plugin projects working	export build ant create script file tab delete set target
137700 Bug Product editor generates plugin list feature based product	plugin action error message title label target feature file editor
164337 exceptions PDE refactoring participant	change refactoring participants create plugin project conditions info delete element
152054 tooltip description	splash property tooltip action dialog entry element title details report
241145 refactoring move code separate plug ins	model add set external plugin workspace target change filter delta
264696 Bug target current target backing target definition file deleted	target location bundle test set read workspace properties form current
258560 Bug API retrieve properties definition files	target profile test location properties bundle set include file read
153093 Inconsistent placement labels update site editor	create handle text site feature editor set update form model
169480 MANIFEST editor display plug names commas	editor model open set export context plugin file create enabled
405015 Bug Unsupported tag secondary type problems created	test problem enum tag create type annotation incremental file build
155158 Product editor doesn support delete key	create handle form model input editor column changed add feature
441883 Bug bidi Compare editors MANIFEST plugin xml enforce LTR	model plugin set file bundle schema create extension open editor
222753 Bug Prompted rebuild	test save type validate delta error local anonymous product file
202272 drop fragment project Overview tab confusing	plugin action title label error message editor target file build
163384 Wrong order classpath entries hosting	test source classpath project bundle build add plugin entries model
227904 Bug editor polish	outline form range editor context model content source input create
233034 Bug Error message missing arguments	plugin error message action target file title label resolution build
151112 Organize Manifests adds settings META INF Export	plugin action error message title label file target resolution wizard
267848 Bug PDE illegally complains externalized strings	test strings plugin model color selected type supports externalize local
164438 Bug Signed features mistaken plug ins	set feature target plugin model bundle plugins version models features
418392 Bug PDE Build dependency runtime compatibility optional	build source validate test dependency reference add find dependencies entry
203356 target platform looses previous bundles adding directory target plugins	target test bundle location source feature container plugins directory version
406119 Bug Javadoc tag autocomplete work tag	tag method javadoc api type wizard annotation test component annotate
293474 Editing extensions PDE editor creates invalid plugin xml	model plugin extension editor create context file schema outline delta
153195 Create OSGI Bundle Manifest generates exports CVS metadata	build bundle file export create profile api source target info
201325 Target Editors plug ins features Include plug ins target checked	model target bundle plugin external set add version workspace extract
216703 Validate dialog narrow	create version feature update plugin validate configuration add model web
45695 Bug Tests variables program args working dir	plugin test config launch working program configuration type problem file
175756 PDE imports signatures source	type test source action create api model method outline java
166546 Exporting plug project plug ins classes	model plugin external baseline models workspace bundle set add delta
209554 check problems platform	api set target check problem version bundle location component problems
173712 Plug Project jar wizard fails enable Finish button	plugin wizard option create button model update selection jar properties
138903 Template perspectives extension point	template extension element create point splash wizard set product plugin
201369 Deleting Extension Point file problems	extension schema bundle point registry service create plugin set file
221852 Bug export features enabled SDK	export create feature ant add file button handle selection action
268966 Bug binary plug ins update source attachment replacing existing jared plug ins	source model bundle plugin add classpath build project external workspace
489122 Bug templates annotations OSGi PDE templates	template branding generate resource set directory create schema data file
198309 Preview granular	preview schema create color form outline set editor viewer element
128683 Organize Manifest detect remove exported bundles	plugin action error message title label target add file remove
89782 Manifest builder overzealous	api build plugin markers set bundle manifest test version file
215743 schema errors displayed problems explorer views	set elements outline create problem duplicate api test problems model
228031 Bug Wrong background inheritance preference	test bundle color delta change content xml stream build header
475855 Bug patch TVT IES Platform String concatenation appeared Polish Language	resource bundle library properties target info plugin patch install source
148171 PDE Tools Open Manifest	api file bundle editor manifest test code open execution packages
229070 PDE ignore API errors launching	api problem build version bundle compatibility check validate elements element
160475 Decorate erroneous additional bundles raw editor	target add create project test bundle additional plugin location read
289502 Bug Spell checking issues org eclipse pde doc user toc xml	set outline component toc selection spelling object reference label file
172767 buttons needed target editor	model set create target action button element add handle changed
173791 PDE Tools Organize Manifest incorrectly identifes externalized Bundle Category unused	plugin action error message label title target file resolution wizard
171758 Bug Properties properties	test create properties configuration bundle string site set model location
272107 Bug target Minor issues content tab	plugin action target error title message label file add resolution
298742 Duplicate unordered problems build properties	test set api problem problems duplicate component file project validate
226037 initialization policy target platform based location	target set bundle test model feature plugin version external export
496382 Bug Eclipse app layout Add API Baseline doesn accept app bundle	application product create configuration test extension schema button api feature
218878 Bug prov extend product definition	product create model type feature plugin local anonymous configuration add
247553 Export version creating Plug existing JAR archives	set bundle export site target feature version file cache jar
184068 PDE Tooling support Exports	test set wizard action api bundle update project session create
400129 Bug NPE registering context plugin project	plugin context editor create file type bar open generate set
188168 Errors Workspace dialog displayed	api export severities wizard element compatibility configuration perform version report
122638 Bug Mark deprecated extensions attributes generated schema doc	element attribute schema set model text validate add extension document
212755 PDE error dialog logs error app running	text plugin create dialog error export product image button link
206610 build fresh workspace	build test plugin workspace file model perform ant create models
121622 Bug specific tabs product editor open current	plugin action error message title label target file feature resolution
139037 PDE resolve translated names plugins directory format	target test bundle type source plugins set api button feature
132893 Bug Extension points declared fragments wrong namespace	set search model content assist extension attribute schema proposal form
272164 Bug check box king	create toc text property plugin filter model dialog checkbox patch
150305 Combo box lose cursor Linux	command create combo message bar field update editor option template
183073 Manifest Editors	model manifest editor open change create properties input viewer file
135976 Enhance PDE support extension points namespace	set extension attribute content assist point create service bundle schema
165672 Option wanted add specific plugins minimally required plugins	plugin feature set add bundle plugins model launch button manager
171838 Environment Target editor slow initialize	create form plugin text update arch dictionary init set link
383802 Bug button defaults RAP Eclipse RCP RAP Developers download	tracing set file button workspace size create wizard data tree
181058 Missing friends settable warning error	validate bundle report element attribute error file api property missing
474948 Bug Templates Update RCP template Java	template wizard branding model initial create work initialize parent list
252751 Bug tag tests mysteriously failed	method test type restriction field file api reference multi builder
326472 Bug remove missing plug Target Definition editor	target plugin action error label message title bundle resolution file
302928 Bug Target Definition problems Helios	target bundle profile set bundles location source include element definition
344914 Bug API problems org eclipse base	test set method api bundle problem create markers usage build
483163 Bug Remove unnecessary whitespace eclipse pde repo	create target profile node source include element insert bundle model
187228 Bug RCP templates missing	create template model branding parent work option extension options resource
147298 Dependency Management projects targeting OSGi	api dependencies severities compatibility form version element report bundle project
50018 Bug update path prompt save plugin xml	plugin set file location baseline model workspace create element progress
230248 open plug artifact dialog sort items	button create target set dialog plugin feature model tree selection
247663 Bug outline view displayed garbled text editor overview displayed	plugin action label error title editor message target file wizard
370536 Bug Creating product plugin Extension tab empty editor closed opened	plugin action error message title label target file add wizard
138093 Adding Imported Provide Version	set bundle version test packages element project feature source resolution
154493 plugin xml	baseline model file cache api change save set workspace bundle
225148 PDE target doesn work easily	set target extension element resource check plugin find local create
138127 Dependecy Analysis side edit plugin xml file	api model change set add component element editor tag file
484244 Bug Remove unused methods Activators PDE	filter set unused create remove dependencies search add filters api
258969 Bug API Baseline dialog Browse start current install	baseline set target action combo location property report dialog button
344996 Bug API Freeze check leads NPE	text set file entry workspace create check selection plugin properties
204719 Provide IOExceptions parsing exsd files	set element plugin add api project file schema model template
264106 target Provide careful handling Remove button pressed	target dialog button entry add create set action form update
381875 Bug Javadoc errors org eclipse pde core target	validate build source target entry test errors java severity src
171962 translatable attribute	set attribute model schema selected translatable plugin type strings form
256954 Bug Add quickfix problem reporting api component resolution error	api problem report set location check error version problems create
380857 Bug mixed delimiters	model set parse local test type attribute change string anonymous
170941 Execution Environment launching Eclipse Application	environment dictionary create execution validation test model launch environments profile
307149 Bug Adding packages Manifest rebuild	bundle validate file api packages type add project set manifest
151502 Change order fields extensions	extension plugin set remove extensions model add context schema participants
443338 Bug Errors saving plugin descriptor file	baseline validate build error api filter target entry file source
151501 Vertical layout weird Extensions	category create plugin element splash toc data form set link
201681 Manifest Editors Weird character representing open bracket tree table viewers	set text manifest element table tag add column selection model
223194 Bug failing test	method test type anonymous field multi file inherited application primitive
183260 sync switching targets	target button create debug resource handle add export build launch
154593 PDE Tools Update Classpath deletes Access Rules	classpath library add access entry plugin container compliance source project
265198 target warn compatibility	build compatibility validate source entry test severity set src java
136172 quickfix remove redundant internal	remove set model action add project build bundle participants tree
231409 Bug Conversion org eclipse update core causing weird	set api update wizard declaration project type check model element
465909 Bug GVT Truncation setup Convert Preferences	test api wizard plugin project preferences setup error color listener
267264 target Add group location EditProfileContainerWizard	target button create group update location set bundle combo source
296457 Problems problems quick fixes build properties	test build set api file component location problems problem project
220179 Bug Manifest Editors XMLInputContext erase characters removing nodes	element validate set attribute build report extension add error create
66069 Bug site xml editor Publish command add foo jar	plugin action error message title label file editor target feature
215579 ModelEntry getBestCandidate bad choices	option choice text model form create changed set port base
383001 Bug Typo Key mathProcessorName localization properties file	file change properties manifest model bundle plugin element remove extension
138795 Presentation names features	content configuration set scanner launch target intro text config args
153640 Template OSGi Services Usage SimpleLogService	template wizard set label splash create model extension service bundle
231977 copying multiple extensions triggers java lang ClassCastException	extension element toc plugin set multiple baseline test attributes add
35888 Bug Adding extensions plugin manifest editor	extension form create plugin selection element action handle filter outline
269381 Bug tooling Compiler warnings	validate api bundle version build check action element source compatibility
329287 Bug org eclipse core runtime compatibility registry error removed	problem api compatibility build set validate source registry bundle remove
144967 Bug ITemplateSection typo	template create selection wizard column initialize table form set model
198724 Raise warning bundle classpath source folders	source build entry bundle validate set project java output classpath
230987 Bug DSAddItemAction isn raising IModelChangedEvent INSERT event	node text drop operation insert plugin element model attribute extension
490062 Bug generate lazy activation policy OSGi annotations	set bundle test header build activation export model bin project
222793 Bundle ContactAddress generate warning translated	plugin model bundle file string feature packages element generate create
171601 Remove internal references Java preferences	cache scan set references api type create reference add selection
201306 Bug XMLErrorReporter deprecated calls	schema set source create add attribute model node error deprecated
185955 Target setting Plug Project wizard remembers	wizard option plugin project template model ernationalize dialog plugins work
406112 Bug scan API problems flag collides FLAGS	problem api element type validate version check java attribute scan
120938 Bug Schema editor disabled	action extension filter open editor element model tree plugin selection
218223 Bug PDE editor browse type OOME	entry create category button form dialog type details label export
172675 Provider form fields fragment overview updated externalization quick applied	create form set outline tree link handle viewer ion event
263299 target definition Support appending ini args launch	configuration launch test bundle workspace config start plugin product args
396429 Bug Samples loaded	option extension sample set test create feature element remove model
130199 navigation ManifestEditor	base match extension create initial view api tooling attribute exact
312466 early call modify bundle root leaves WorkspacePluginModelManager initialized	delta version provider test deploy settings data project text listener
90264 Bug nested classes extensions leads ClassNotFoundException	test schema simple plugin find extensions loader read elem tree
172703 list launch shortcuts PDE editor extensible	set launch plugin feature bundle button configuration model plugins tree
273049 Bug CheatSheet Registering cheat sheet fails java lang NullPointerException	model create element form step simple item cheat tree remove
312495 Bug BundleProjectDescription apply slow call clean workspace	file create workspace model input block test editor tab configuration
149676 Plugin manifest editor suggestion efficiently search extension	plugin action error label message title target file wizard resolution
65204 Bug XSLT web site xml supported Mac Safari	site web set project file location tooling session writer element
205493 Invalid Manifests multiple BundleDescription project	plugin action error message title label target file project wizard
484548 Bug Feature manifest file label NPE clicking Dependencies tab	plugin action label error target message title feature file add
243911 Bug Adopt Ant API	ant export build set source create script delete test workspace
248519 Bug tooling Component Definition Fields SWT BORDER style	set session action target create tree viewer form filter selection
228044 testApplication parameter unusable product	parameter test param type create command plugin launch text args
158418 Creating osgi bundle project adds lazy start header	bundle set validate header completion required export handle version activation
203993 Schema HTML generator CHKPII errors	plugin error target action build message title file label export
257246 Bug Compiler warnings	validate bundle element build attribute source error src test control
233699 Bug Add support version types OSGi	bundle version api completion source type check handle problem tag
310496 Bug NLS string	test method product type local anonymous illegal component image javadoc
314595 Prevent PluginModelManager instantiated	plugin feature bundle container schema dependencies object site model source
300771 Bug Dead code pde	create form editor start content hyper supports context creation input
181997 Bug AbstractLauncherToolbar leaks menus	action bar model feature menu type parent create work test
217333 MainTab Location hyperlinked	workspace location create container set target drop manifests input data
191231 Binary compatibility breakage method removed AbstractLauncherTab	api test problem create version selection compatibility method add perform
482554 Bug Warning org eclipse pde runtime	test image create form plugin message error project validate size
61184 Bug Browse button extension work	schema button text export file plugin browse destination category combo
191232 Binary compatibility breakage method removed EquinoxPluginsTab	api test problem create version selection compatibility method add perform
177420 EquinoxLaunchConfiguration bundle version launching	test target launch feature configuration bundle set plugin launcher plugins
225047 Bug DBCS Externalize Strings halts DBCS characters	change properties file strings manifest table participants set model input
129817 Bug dependencies templates longer	template model create work add option file extension plugin application
166680 META INF bundle manifest	model file bundle delta extension set remove validate manifest schema
319268 Bug PDE confused PDE projects	project source projects plugin build set workspace api target create
469803 Bug patch Eclipse SourceReferences supported ctrl space suggestions	patch create tree feature text set settings filter form site
63287 Bug Flickering â€œImport plug insâ€ dialog Mac	source model bundle args win set project plugins target plugin
149816 Manifest Editor plugin xml source editor syntax coloring confused	plugin action title error message editor label file target wizard
232771 Unexpected confirmation dialog launching	workspace export configuration create incremental build framework initialize validation launch
307524 org eclipse wst xml Plug Manifest Editor unreliable	set file extension editor model delta plugin schema manifest open
230209 Bug api tooling Illegally instantiates flagged extending noinstantiate	test wizard type api javadoc user usage local anonymous update
417603 Bug Unjustified tag error incremental build	method test incremental annot leak field valid tests annotation tag
274765 Bug target Cancelling resolution editor closed raises assertion failure	plugin action target error message title label resolution feature file
173393 Bug Missing Entries Manifest generated Template Wizard	plugin action error message title label target file wizard editor
226640 Bug Missing tags	tag type api method resolution declaration annotation test field update
260953 Bug Importing fragment Export headers forgets java nature	bundle validate set test add project create export plugin header
488805 Bug DSAnnotationCompilationParticipant performs unnecessary model modification	model file project change bundle editor context modification open participants
218983 Bug Save cycle sync resources	model version create feature context file product work add settings
117094 Bug TVT TCT plug key change word order required	option template control content perform preference create text combo token
367980 Bug Support pre release versions	source tree checked target create ion refresh filter baseline destination
216946 Unable JUnit tests org eclipse jdt junit runtime target platform	test target bundle feature plugin arguments dictionary project directory source
203126 Bug WorkingSets location WorkingSetConfigurationBlock changed implementors	set source plugin project create bundle build wizard delete list
409969 Bug Target Platform	target test bundle feature model location version plugin properties directory
227706 Bug filter Method API parameter breaks rebuild	test create param problem parameter type file save command tag
482171 Bug PackageSelectionDialog filter startswith	match test plugin range element filter properties create tree pattern
173447 Generated schema description valid HTML	element set schema attribute process document type model plugin deprecated
185225 view doesn refresh plug	action model active view tree bundles menu viewer selected selection
234376 Plug project property template deprecated elements	plugin template option wizard model create bundle project add set
220069 Plug ins view malformed content description	model content action external set plugin add workspace manager handle
304041 Bug Compiler warnings	validate bundle element build attribute source error src test control
206765 PDE shoud ignore osgi Manifests workspace projects	plugin set project workspace create add launch build manifests remove
241074 templates HelloRCP template externalized strings	create model wizard plugin strings color externalize supports extension ernationalize
108466 Dups Eclipse ClassLoader getResources String	create filter test plugin source remove set input structure store
79794 Adopt hyperlink feature	create link hyperlink text event form product feature register content
217022 PDELabelProvider handle system bundle	target model add create set form plugin handle location external
486328 Bug Warning pde core pde	source test plugin project build create image form set entry
226254 Bug API tools memory	test api changed type lambda description profile local anonymous template
183250 Product Editor add duplicate features	plugin action error message title label file target feature product
383448 Bug osgiminimum missing Principal	set missing bundle build validate target report problem add api
477658 Bug multi FeatureExportOperation log error	target build missing export bundle error header feature exception invalid
207836 Search extension point references don multiple versions	search extension plugin find add element registry create point set
479192 Bug Warning PDE moving java	source test project image build entry set message bundle size
146912 AbstractModel update NLResourceHelper bundle localization	model plugin create set document file bundle resource extensions change
226788 PDEModelUtility cache correctly	cache api type baseline tree set scan checked refresh location
98790 Bug Leakage UndoActionHandler RedoActionHandler disposed open close plugin xml	api file type count component write bundle spy table editor
170474 Dependancies initially project creation wizard	plugin project wizard creation create template fragment add user data
342512 Bug Plug Manifest Editor adds garbage mnemonics saving	option bundle file set plugin editor open model parent extension
206335 convertSchemaToHtml task problems plugins	missing set target api report error header bundle export location
68606 Bug Plug Project wizard error creating box project	plugin source project toc model set build wizard data create
