209410 bot improve documentation feedback error handling	room bot registry tracker message container factory iim entry extension
275722 abstraction ECF	ecf service naming list context bundle type authority weight services
207372 Bug doc remoteservices create test code code documentation	operations listener model strategy iator active str synchronization selection local
313365 Activate APITooling checks	task length block window workbench list linked activate action
486675 Bug ecf Improve server side keepAlive handling	server search container group manager result user tcp groups simple
19733 Bug content assist Code assist closes list filter items	command listener item online list proxy search label filter config
288029 Bug org eclipse ecf provider filetransfer missing tags license headers	socket file http response relative search method gzip transfer connect
229921 Missing javadoc statements compiler error	plugin service search bundle resource fand loading issue content group
230183 remotesvcs Remove create org eclipse ecf discovery identity IServiceID java lang String	service container registered services listener type adapter discovery composite info
266539 Discovery zeroconf services	container service discovery expect time registered raspberry services naming authority
198193 Bug IRC support special characters connecting IRC server	connect irc room container user text listeners message manager tracker
244784 Discovery jSLP Move Maintain jSLP code base Eclipse org	service discovery context bundle advertiser locator container jslp factory type
264242 Bug Remove Serializable org eclipse ecf core util Event interfac	message ping event object thread search send shared lock handler
194101 Increase user info pop time delay	listener info service ned chats config event listeners host dns
303667 Discovery jSLP Write XML report tests	service discovery description context bundle factory info advertiser endpoint writer
371768 Zoodiscovery NPE unpublishing service	data service log conf file server configs local running root
90428 Jabber Provider Character allowed Jabber login names	roster providers bookmarked conf provider data address room search user
302394 Discovery jSLP Test parser bad tags	
192573 Bug Send Request Open Resource fails incorrect message	message local search object event resource client send chat container
398676 Bug Remove system property change protocol	service file protocol connection registry proxy context response tracker transfer
333137 Discovery view open properties view	action endpoint node connect type label service drop view chat
320081 Discovery Add functionality insert service manually	discovery endpoint service methods container description info factory test manager
342352 TCK RSA exports properties	service proxy container registration listener endpoint export tracker factory bundle
220258 Download jobs download speed	file pieces hash listeners speed piece thread text digest check
473446 Bug xmpp provider generalize XMPP equals include resource prefixes	xmpp roster container packet google server listener helper handler event
302439 Bug Discovery jSLP tests distributed OSGi remote services	service discovery context bundle advertiser locator container jslp factory type
265312 Discovery JMDNS Replace binary jar sources	service tracker discovery proxy lifecycle add admin factory handler instance
257381 Discovery Reduce BREE Java	service discovery type container listener methods bundle test hook find
310114 Bug core remove dependencies ECF OSGi frameworks	services service list search bundle time remote xied manager strategy
292972 Bug filetransfer apply additions fixes genuitec patch	timeout buffer error message res list additional values validator input
389230 Filetransfer testcases fails references files archived ECF repositories	file browse system chat client container transfer browser drop target
303215 Bug update examples clients examples	site service context advertiser discovery http bundle update type directory
193136 IRC Add IRC server	connect irc room container user listeners tracker registry channel data
324215 remoteserviceadmin remoteservices implement remote services admin spec	endpoint discovery view content service description rsa admin viewer tree
238970 MSN CPU usage increases connecting	listeners msn address ticket message roster connect invalid client server
267390 file based discovery	service data log conf file type configs mode running limit
198012 provider connect receive hyperlink	shared connect client editor collab wizard action object container list
238976 Shared Editor notification connect disconnect connection	shared connect container editor client list file collab chat object
408450 TCK Workaround slp string decoding	sig erred suspend dec pref length buffer encoding odabet bytes
266640 Discovery simplify discovery host service labels	discovery service data container test target naming authority connect advertiser
338578 Bug docs generate ECF javadocs move eclipse org	message docs send manager strategy tracker factory service data listener
198043 open contacts dialog doesn recognize users groups	action search dialog contact roster message chat manager drop room
249240 remotesvcs Implement RFC	srv service address dns url rqst rply type min stream
275359 remove deprecated methods	viewer method packet invocation ack methods compression timeout array text
194975 Method connect providers obvious	providers manager provider extension
321690 namespace glitch org ecllpse	factory code names iid paces hash ture initialized element
273819 Containers instantiated time wizard opens	wizard shared container client editor collab connect list viewer object
295335 Discovery jSLP Execute OSGi jUnit tests separately collect	discovery service methods hook find context bundle advertiser test left
321708 Modularize XMPP provider WRT remoteservices datashare dependencies	services service time remote xied handler usage channel simple redundant
207530 Bug Collab Cola Real Time Shared Editor support multi character operations	editor shared client collab object operations group action list init
225199 Translation Clarification org eclipse ecf provider filetransfer	socket stream proxy config helper event connecting scp method head
244908 Discovery Thread safety providers	icon debug providers service manager info thread ger bed popup
296107 Discovery jSLP discard SLP protocol messages version	service socket discovery local daemon slp multicast type ion erved
325813 remoteservices provider XML RPC provider ECF	service rpc servlet handler xml application host context bundle server
287666 releng filetransfer Removed javax microedition	context info service ssl tracker socket factory protocol names impl
263858 Bug Missing project specific settings	text email search start location time connect sound content setting
316595 Discovery Defer service retrieval unit tests	wizard defer methods discovery compare directory point output hook array
277176 Service Discovery view working osgiservices	endpoint node action type service proxy async label bytestream discovery
196541 wizards Passwords reset user input username field	server search text login client ticket port user store password
183492 ECF Server Application launch config	container service processor server manager channel context lock bundle app
410048 Kepler Archive ECF builds download eclipse org	file text info manager pass torrent password user hash path
472769 Bug improve connect handling provider server	http socket xmpp file room response relative gzip host proxy
221139 wizards Weak mail address validation User field	caps manager work listener jid room info ver fields anization
265174 Bug Visual distinction Sync diagrams	search operations message connect sync manager bundle context strategy factory
112597 Bug Features	caps data service node info weak search message ver persistent
165082 Partial core util Visibility ECF	transfer file wildcard connection proxy response http container namespace output
218584 remoteservices add invoking remote methods classes	service update registry server viewer request remote connect invocation reg
271323 Bug improve shared object API performance	message action listener shared list manager send base strategy selection
249061 Bug Support client demand proxy creation XMPP provider	proxy http socket response file bytestream listener listeners creation supported
324333 Bug remote service exception client timeout	http response connect socket file proxy config timeout helper transfer
192756 IRC channel join rid entered spam	irc connect room container user listeners manager channel data handler
420858 OSGi Sync net ECF codebase	service executor manager share event asynch tracker strategy synchronization listener
180751 Bug MultiRosterContentProvider objects tacked	object search type shared container wait content osent client cont
202772 Broken statement pubsub	node namespace pub map
280601 Bug removePresenceListener adds listener removing	listener presence roster event listeners request notification manager torrent hash
333850 osgi Remote service remote reference	service tracker remote context container admin reference services handler channel
187936 Bug IChat provide simpler sending chat messages	message chat send data javadoc comma analyzer nds base manager
482862 Bug bundle loadClass prevention java deserialization attacks	service message manager search bundle discovery listener call registry strategy
312363 Bug remoteservices osgi incomplete handling proxy clean	listener service http container file socket context system remote proxy
332851 Discovery ZooDiscovery ServiceName ServiceInfo unset causing NPE	service discovery site info instance notification live count thread time
406064 Discovery ZooDiscovery high cpu percentage server client zookeeper	data service log conf file server configs local running root
280132 Bug remoteservices exception thrown timeout include info	include replica creation code packet error filter time server env
232006 connect xmpp chat room	room container xmpp chat namespace user message manager google object
199259 discovery ServiceInfo constructors cumbersome	service time expect discovery info instance count thread notification type
256605 Discovery Remotesvcs Replace serviceAccessHandler command handler based approach	service chatroom input handler image menu bot message room chat
320612 Discovery Unit tests fail broken detection external address	res factory socket output uriid namespace directory add ses protocol
285801 Bug Remove unnecessary host lookups	list cache socket host file create str http relative search
485482 Bug remove code org eclipse ecf provider discovery	service discovery node published services properties reference container test info
331383 Remote services Java primitives fail	service xmpp time container filter expect context connect events wait
318075 Discovery Whitespaces allowed property	discovery service container methods test resses hook find rox connect
408185 Bug TCK Bug handling multiple versioned exports single	listener room search bundle multiple address manager strategy tracker factory
171138 collection created IContainers needed	wizard manager defer packet jid chats compare point array sockets
125572 ECF provider thread interlock	thread object pos factory bulletin server accept socket message skipped
292995 Timeout number huge httpclient download	pieces file hash listeners connect piece connection speed manager digest
224907 Translatable	
280205 Bug Installer fails install large products repositories artefacts compressed pack	pull executor server reader simple thread xmpp file tmp connection
234142 Bug modelsync DocShare plug split core	operations message listener str shared share ticket docs hare send
316071 Bug Problem registering finding remote services	create existing local endpoint registered filter svcs listener ains dom
471213 Bug bug Activator registry	http message socket file relative search method gzip transfer connect
314558 Discovery DNS Add API checks test suite	listener test failed discovery tistical lock loc adv advertiser error
176322 Bug Refactoring move Eclipse runtime bundle	service message factory discovery socket color search bundle helper manager
313029 Bug HttpClient http content ISO UTF	http socket file conn relative stream connection simple transfer connect
265408 Discovery Composite CompositeService ContainerEvent API	discovery methods test hook find service registration left container ecf
218308 Bug Discovery jSLP org eclipse ecf discovery IDiscoveryContainerAdapter getServices doesn reachable services	service container discovery time type instance registered red notification events
166603 Bug Authentication failure returned client	http socket search proxy config helper event connecting authentication head
278222 Bug core improve error message container type	message srv service rqst rply type error send container room
327379 IRemoteCallFactory	
267481 server supporrt remoteservice container adapter server	service simple container reference server ssl tracker registration remote
337624 Discovery ZooDiscovery silencing zookeeper startup publish shutdown	service write log data zoo conf bundle stopping root node
499942 Bug osgi remoteservices incompability OSGi registered services	listener service manager container local endpoint registered svcs topology reference
219878 core deprecated Eclipse LazyStart manifest entries	bundle adapter description store roster async proxy container iid endpoint
273135 LogService implementation misses details logging	service cache list factory description tracker registration registrations details session
499946 Bug remoteservice osgi remote service unregistration clean properly	service endpoint writer description format simple reference event export mask
337653 Bug remoteserviceadmin discovery add support allowLoopbackReference endpointListenerScope system properties	service factory description endpoint tracker registration registrations existing create properties
478452 Bug NPE AbstractTopologyManager shutdown	socket factory service packet search bundle test listener helper endpoint
223484 threads remain disconnect XMPP server	ping connection packet listener xmpp compression listeners container manager thread
181506 Migrate presence providers MessagesView	search message dialog connect chat set contact tab column view
327936 Bug remoteservices remove obsolete classes	node endpoint type search label async service content discovery invocation
264962 Bug PersistenceContext annotated field Entity EntityManagerSetupException	caps http socket file search ver proxy weak manager transfer
404763 support usage ECF remote services	service context admin container services remote tracker impl event lock
328999 Discovery resilient broken hostnames	service discovery locator properties container comparator lock
400164 Bug Add API customization proxy creation	proxy http response socket file host bytestream listener listeners connection
269091 Incorrect file requests address host	socket proxy connect listener server bytestream connection timeout add res
341818 Bug rosgi System thread resources osgi provider	socket manager service proxy config helper web event sockets connecting
257864 Turn checked runtime exceptions	event distributed test admin send
339790 Bug remoteservices registry start remote service ids	registry endpoint action update request service reg connect desc queue
233808 Discovery SLP org eclipse ecf tests discovery DiscoveryTest testAddServiceListenerIServiceTypeIDIServiceListener fails SLP provider	discovery add resses container test jslp
216405 Migrate jSLP contribution ecf osuosl org dev eclipse org	wizard service item contribution selection type parent workbench element
256853 remoteservices insufficient cleanup RegistrySharedObject handleCallResponse	service shared registration registry object impl adapter remote
207706 xmpp XMPPContainers registered IPresenceServices	command manager service proxy mechanisms sasl info listener bin xmpp
339291 Bug server add convenience api	search server ticket packet thread list command file pinging tmp
251740 filetransfer plan create filetransfer provider httpclient	socket http proxy config helper head factory connecting event host
473443 Bug Base classname disambiguated Java	message object res list send code data error type javadoc
234342 Bug Improved retrieval remote filename	bundle description init iator thread packet filter output transfer stream
327029 OSGi RemoteSrvs Smart Proxy delegate original method	service container proxy listener lifecycle imports map hash lock data
246155 Support multiple user log ins username password	file mechanisms sasl bin stream host creation count supported mechanism
197007 IChatRoomContainer getCurrentParticipants	room manager selection structured view container chat
321428 RemoteSrvc OSGi DistributionProvider tests leave service registered test failure	test service failed discovery methods tistical directory output hook find
411543 Bug Imports org xml javax xml manifest	handler bundle service xml prefix handle sasl description endpoint authentication
174480 Missing NLS message	service services list search time resource bundle remote xied handler
266140 HttpFileRetrieveTransfer detect malformed URL	server max iters simple type imum file service tmp user
254872 Convert org eclipse ecf core identity IDCreateException RuntimeException	discovery container object factory iid red names service paces tracker
384431 Bug Provider prints error message log unnecessarily conditions	socket manager factory local bundle plugin tracker daemon slp helper
321469 Bug remoteservices osgi improve clean DiscoveredServiceTracker	service listener container app context lock bundle manager registration type
264126 BREE include Foundation	include replica listener file transfer wait chunk size time server
337345 Bug remoteserviceadmin Service Info publish endpointDescription	service tracker registration container listener description endpoint locator bundle proxy
223178 BitTrrent displayed drop list Connect Provider button tool bar	action viewer room chat text roster account drop set button
433111 Bug TCK Handling multiple exports serviceReference correcting	service tracker container factory existing proxy imports map admin listener
223207 filetransfer api handling lastModified timestamp	file http socket event browse system proxy config helper head
329197 Compiler errors projects OSGi API	endpoint output ening sync acc eptor server shared projects block
471541 Bug ClassCastException JUnit integration tests	output directory
198132 Bug IRC client occassionally	manager room hyperlink action text label type message view chat
221177 obtaining remote file	file efs remote attributes info attribute
315897 org eclipse ecf filetransfer IncomingFileTransferException File	transfer response file factory proxy connect events container retrieve code
