209410 bot improve documentation feedback error handling	 room message bot extension context container connect chat pre load
275722 abstraction ECF	 ecf service item log trace platform type filter info set
207372 Bug doc remoteservices create test code code documentation	 document editor message create adapter synchronization set start local share
313365 Activate APITooling checks	 editor marker open init ening pull activation shared task set
486675 Bug ecf Improve server side keepAlive handling	 server container connect servers group buddies create list handle data
19733 Bug content assist Code assist closes list filter items	 item command set privacy list content configuration commands request response
288029 Bug org eclipse ecf provider filetransfer missing tags license headers	 receive file connect response host request event set connection transfer
229921 Missing javadoc statements compiler error	 server element container missing plugin service register read ents log
230183 remotesvcs Remove create org eclipse ecf discovery identity IServiceID java lang String	 service discovery namespace type endpoint services discovered info listener container
266539 Discovery zeroconf services	 service discovery set listener services test container type info register
198193 Bug IRC support special characters connecting IRC server	 channel message room connect user handle send irc create hyperlink
244784 Discovery jSLP Move Maintain jSLP code base Eclipse org	 service test parameter discovery jslp instance context create bundle naming
264242 Bug Remove Serializable org eclipse ecf core util Event interfac	 send object socket handle address parse event listener properties room
194101 Increase user info pop time delay	 service set info reconnection listener socket configuration local event add
303667 Discovery jSLP Write XML report tests	 service test discovery type description endpoint container string server info
371768 Zoodiscovery NPE unpublishing service	 service flavor ips port discovery config node connection version parameter
90428 Jabber Provider Character allowed Jabber login names	 data search roster bookmarked extension revoked granted add element pull
302394 Discovery jSLP Test parser bad tags	 test service string discovery endpoint output bad info type create
192573 Bug Send Request Open Resource fails incorrect message	 send file handle message receive user container editor event chat
398676 Bug Remove system property change protocol	 file set factory excluded socket header response proxy retrieve ompressed
333137 Discovery view open properties view	 view create endpoint drop account roster chat room connect context
320081 Discovery Add functionality insert service manually	 service discovery namespace container endpoint ping create test add listener
342352 TCK RSA exports properties	 service visit endpoint bundle proxy container insn export set properties
220258 Download jobs download speed	 file piece download torrent event hash start create transfer add
473446 Bug xmpp provider generalize XMPP equals include resource prefixes	 connect roster event packet namespace set object send escape manager
302439 Bug Discovery jSLP tests distributed OSGi remote services	 service discovery test type attributes string toj remove create naming
265312 Discovery JMDNS Replace binary jar sources	 service visit type remote method discovery channel bundle endpoint test
257381 Discovery Reduce BREE Java	 service set discovery container type services search string composite registration
310114 Bug core remove dependencies ECF OSGi frameworks	 stream remote service message bundle lease channel doc endpoint socket
292972 Bug filetransfer apply additions fixes genuitec patch	 request http create dialog response remote client error prepare method
389230 Filetransfer testcases fails references files archived ECF repositories	 file browse drag system chat drop remote access operation content
303215 Bug update examples clients examples	 context servlet site service properties http server mime type security
193136 IRC Add IRC server	 channel message handle connect room user combo send create chat
324215 remoteserviceadmin remoteservices implement remote services admin spec	 endpoint node context create view child remote string update set
238970 MSN CPU usage increases connecting	 contact roster message set listener presence container manager fire user
267390 file based discovery	 service file set create config search system input info element
198012 provider connect receive hyperlink	 hyperlink create set messages connect hyper open container type torrent
238976 Shared Editor notification connect disconnect connection	 connect set container message create handle manager group target send
408450 TCK Workaround slp string decoding	 string log trace object bytes encode offset encoding platform address
266640 Discovery simplify discovery host service labels	 service ecf discovery set adapter create query naming test type
338578 Bug docs generate ECF javadocs move eclipse org	 send request http container parse room message doc search input
198043 open contacts dialog doesn recognize users groups	 contact set drop add account create user container chat roster
249240 remotesvcs Implement RFC	 service domain cookie invalid compare attribute header find parse properties
275359 remove deprecated methods	 connection packet compression set idle shell roster timeout add member
194975 Method connect providers obvious	 file set transfer remote parameter connect retrieve service call listener
321690 namespace glitch org ecllpse	 namespace factory string create extension external parameter supported file compare
273819 Containers instantiated time wizard opens	 wizard remote service create element connect combo finish category collection
295335 Discovery jSLP Execute OSGi jUnit tests separately collect	 service discovery test container composite string type toj context bundle
321708 Modularize XMPP provider WRT remoteservices datashare dependencies	 service stream remote message send channel template lease container bundle
207530 Bug Collab Cola Real Time Shared Editor support multi character operations	 editor change remote local marker contribution open shared resource bundle
225199 Translation Clarification org eclipse ecf provider filetransfer	 file set setup system client request host socket received time
244908 Discovery Thread safety providers	 service discovery type provider set add listener connection window event
296107 Discovery jSLP discard SLP protocol messages version	 service message multicast res receiver parameter jslp gram discovery test
325813 remoteservices provider XML RPC provider ECF	 remote rpc client servlet supported service create external endpoint command
287666 releng filetransfer Removed javax microedition	 socket service client factory issue info connection nected context bundle
263858 Bug Missing project specific settings	 set connect combo chat element object update pull settings sound
316595 Discovery Defer service retrieval unit tests	 service discovery wizard element test message category collection finish listener
277176 Service Discovery view working osgiservices	 endpoint create bytestream remote set service stream context viewer view
196541 wizards Passwords reset user input username field	 connect create contact server set user field client session socket
183492 ECF Server Application launch config	 server container shared args group create context object application channel
410048 Kepler Archive ECF builds download eclipse org	 file download torrent set max input endpoint dialog hash preference
472769 Bug improve connect handling provider server	 connect file host response client connection event set setup matching
221139 wizards Weak mail address validation User field	 set caps append packet chat field local string address info
265174 Bug Visual distinction Sync diagrams	 dialog create remote buddies container connect message sync strategy doc
112597 Bug Features	 caps ecf node set info add entity revoked granted features
165082 Partial core util Visibility ECF	 set service event stream response file user create connect search
218584 remoteservices add invoking remote methods classes	 remote service call add request proxy async registry event handle
271323 Bug improve shared object API performance	 message send container parse room shared search doc object directory
249061 Bug Support client demand proxy creation XMPP provider	 account set host connect request response bytestream file proxy stream
324333 Bug remote service exception client timeout	 request client response http file setup connect create remote event
192756 IRC channel join rid entered spam	 channel room user message handle send irc container chat invitation
420858 OSGi Sync net ECF codebase	 service listener strategy call remote synchronization time async executor asynch
180751 Bug MultiRosterContentProvider objects tacked	 remote service object shared member parse factory offset pattern group
202772 Broken statement pubsub	 element items pub item session pull pubsub delete node create
280601 Bug removePresenceListener adds listener removing	 listener add remove event notification message send presence download max
333850 osgi Remote service remote reference	 service remote container create output update channel endpoint bundle properties
187936 Bug IChat provide simpler sending chat messages	 message room send search chat parse manager container invitation table
482862 Bug bundle loadClass prevention java deserialization attacks	 proxy service async send parse message call container room log
312363 Bug remoteservices osgi incomplete handling proxy clean	 file service context proxy remote doc request setup listener container
332851 Discovery ZooDiscovery ServiceName ServiceInfo unset causing NPE	 service discovery test context type connection initialize property fire services
406064 Discovery ZooDiscovery high cpu percentage server client zookeeper	 service flavor ips port discovery config connection version node parameter
280132 Bug remoteservices exception thrown timeout include info	 account service compliant message test post supports head replica host
232006 connect xmpp chat room	 room message chat connect container presence create handle invitation manager
199259 discovery ServiceInfo constructors cumbersome	 service test discovery container listener services discovered type context add
256605 Discovery Remotesvcs Replace serviceAccessHandler command handler based approach	 room service entry menu container roster command manager split xml
320612 Discovery Unit tests fail broken detection external address	 test service set discovery create add type socket services address
285801 Bug Remove unnecessary host lookups	 host connect set file cache remote response event socket change
485482 Bug remove code org eclipse ecf provider discovery	 service discovery node test discovered services endpoint add container set
331383 Remote services Java primitives fail	 service test client filter remote register services endpoint discovery create
318075 Discovery Whitespaces allowed property	 service test property discovery set services time compare message add
408185 Bug TCK Bug handling multiple versioned exports single	 set client listener room add offset reconnection bundle service doc
171138 collection created IContainers needed	 create wizard chat element packet socket roster message category collection
125572 ECF provider thread interlock	 message create accept thread event pos address shared deliver handle
292995 Timeout number huge httpclient download	 piece connection set request host timeout hash torrent download event
224907 Translatable	 
280205 Bug Installer fails install large products repositories artefacts compressed pack	 receive file start test offset packet parse parser access sig
234142 Bug modelsync DocShare plug split core	 send contact message parse change container room remote board session
316071 Bug Problem registering finding remote services	 service endpoint container remote filter description mode args registration host
471213 Bug bug Activator registry	 connect send file client response host event parse room socket
314558 Discovery DNS Add API checks test suite	 service test discovery context add listener itative server advertiser type
176322 Bug Refactoring move Eclipse runtime bundle	 send parse room service message search log capture bundle table
313029 Bug HttpClient http content ISO UTF	 test request file receive connect set connection header response host
265408 Discovery Composite CompositeService ContainerEvent API	 container service composite discovery supported type test instance context create
218308 Bug Discovery jSLP org eclipse ecf discovery IDiscoveryContainerAdapter getServices doesn reachable services	 service discovery test type container services set listener search registration
166603 Bug Authentication failure returned client	 file authentication client setup listener system request host server connect
278222 Bug core improve error message container type	 container message send service type input connect adapter dialog create
327379 IRemoteCallFactory	 
267481 server supporrt remoteservice container adapter server	 service server container remote register ents exported test missing wait
337624 Discovery ZooDiscovery silencing zookeeper startup publish shutdown	 zoo config service write port bundle flavor stopping ips set
499942 Bug osgi remoteservices incompability OSGi registered services	 endpoint service remote context manager registered event attributes filter topology
219878 core deprecated Eclipse LazyStart manifest entries	 bundle test container roster entries store image create description endpoint
273135 LogService implementation misses details logging	 cache connection service max type set list expired details supported
499946 Bug remoteservice osgi remote service unregistration clean properly	 service remote container event admin reference string endpoint print type
337653 Bug remoteserviceadmin discovery add support allowLoopbackReference endpointListenerScope system properties	 service endpoint create properties container config string add discovery serializable
478452 Bug NPE AbstractTopologyManager shutdown	 connection set packet endpoint manager compression stream socket send registered
223484 threads remain disconnect XMPP server	 packet connection ping object listener connect handle send stream address
181506 Migrate presence providers MessagesView	 send file handle chat message create open user editor text
327936 Bug remoteservices remove obsolete classes	 service socket remote listener string search remove add sockets relative
264962 Bug PersistenceContext annotated field Entity EntityManagerSetupException	 set caps field type connect string async request add event
404763 support usage ECF remote services	 service remote connect container context listener create services reg method
328999 Discovery resilient broken hostnames	 service contact session message discovery filter test changed time parent
400164 Bug Add API customization proxy creation	 request host file response connection stream connect bytestream set event
269091 Incorrect file requests address host	 socket connection bytestream host local connect proxy set request http
341818 Bug rosgi System thread resources osgi provider	 file client setup supported time matching remote host system context
257864 Turn checked runtime exceptions	 set service message compare send connect container checked share data
339790 Bug remoteservices registry start remote service ids	 remote service request registry add call endpoint event handle context
233808 Discovery SLP org eclipse ecf tests discovery DiscoveryTest testAddServiceListenerIServiceTypeIDIServiceListener fails SLP provider	 service discovery test time trace add enabled failer gram container
216405 Migrate jSLP contribution ecf osuosl org dev eclipse org	 contribution service wizard discovery menu create container roster share parameter
256853 remoteservices insufficient cleanup RegistrySharedObject handleCallResponse	 service remote container call adapter member registry add async send
207706 xmpp XMPPContainers registered IPresenceServices	 command bytestream data service set manager stream authentication add remove
339291 Bug server add convenience api	 receive contact session file test user buddies board create event
251740 filetransfer plan create filetransfer provider httpclient	 socket file setup client host system time http connect request
473443 Bug Base classname disambiguated Java	 send parse room search message object method types type java
234342 Bug Improved retrieval remote filename	 file bundle stream transfer set message status flexible description endpoint
327029 OSGi RemoteSrvs Smart Proxy delegate original method	 visit proxy service remote async method insn set call invoke
246155 Support multiple user log ins username password	 account file test set host authentication proxy prompt credentials eractive
197007 IChatRoomContainer getCurrentParticipants	 room container chat message send detector viewer rate delegate password
321428 RemoteSrvc OSGi DistributionProvider tests leave service registered test failure	 service test container discovery add composite type listener failed services
411543 Bug Imports org xml javax xml manifest	 handler bundle receive set setup file response start servlet element
174480 Missing NLS message	 stream remote service server message element bundle lease missing read
266140 HttpFileRetrieveTransfer detect malformed URL	 receive cookie test file domain detect invalid string path parse
254872 Convert org eclipse ecf core identity IDCreateException RuntimeException	 service container discovery namespace create search object connect listener file
384431 Bug Provider prints error message log unnecessarily conditions	 service log message platform manager namespace trace multicast string element
321469 Bug remoteservices osgi improve clean DiscoveredServiceTracker	 service context container properties string offset discovered remote sig bytes
264126 BREE include Foundation	 set method query form test include field string compliant transfer
337345 Bug remoteserviceadmin Service Info publish endpointDescription	 service endpoint bundle description container properties create event locator export
223178 BitTrrent displayed drop list Connect Provider button tool bar	 create set drop account room viewer dialog roster text manager
433111 Bug TCK Handling multiple exports serviceReference correcting	 service visit set remote insn channel endpoint container doc bundle
223207 filetransfer api handling lastModified timestamp	 file remote setup system adapter client host transfer connect request
329197 Compiler errors projects OSGi API	 remote block start message listener sync admin container endpoint scheduling
471541 Bug ClassCastException JUnit integration tests	 test send container connect channel start tests context bundle server
198132 Bug IRC client occassionally	 hyperlink hyper manager message room append label type channel irc
221177 obtaining remote file	 file remote listener browse system connect set modified unknown content
315897 org eclipse ecf filetransfer IncomingFileTransferException File	 file retrieve event set transfer request connect response stream listener
